Serial No,Customer Name,Customer Mobile Number,Customer Email,Account Number,Account Type,Customer Address,Branch Name,IFSC Code,MICR Code,Branch Address,Transaction Date,Transaction Time,Value Date,Description,Cheque Number,Debit,Credit,Balance
1,Customer1,1234500001,c1@gmail.com,1,Savings ,Customer_Address1,Branch1,BARB0IFSC1,MICR1,Branch_Address1,05-01-2023,14:30:00,05-01-2023,ATM Withdrawal,,5000.0,,145000.0
2,Customer1,1234500001,c1@gmail.com,1,Savings ,Customer_Address1,Branch1,BARB0IFSC1,MICR1,Branch_Address1,12-01-2023,11:45:00,12-01-2023,Online Shopping - Amazon,,3500.0,,141500.0
3,Customer1,1234500001,c1@gmail.com,1,Savings ,Customer_Address1,Branch1,BARB0IFSC1,MICR1,Branch_Address1,18-01-2023,10:00:00,18-01-2023,Electricity Bill Payment,,2200.0,,139300.0
4,Customer1,1234500001,c1@gmail.com,1,Savings ,Customer_Address1,Branch1,BARB0IFSC1,MICR1,Branch_Address1,22-01-2023,16:20:00,22-01-2023,Restaurant Payment,,1800.0,,137500.0
5,Customer1,1234500001,c1@gmail.com,1,Savings ,Customer_Address1,Branch1,BARB0IFSC1,MICR1,Branch_Address1,28-01-2023,9:30:00,28-01-2023,Salary Credit,,,65000.0,202500.0
6,Customer1,1234500001,c1@gmail.com,1,Savings ,Customer_Address1,Branch1,BARB0IFSC1,MICR1,Branch_Address1,02-02-2023,13:15:00,02-02-2023,Grocery Shopping,,3200.0,,199300.0
7,Customer1,1234500001,c1@gmail.com,1,Savings ,Customer_Address1,Branch1,BARB0IFSC1,MICR1,Branch_Address1,09-02-2023,15:45:00,09-02-2023,Mobile Recharge,,999.0,,198301.0
8,Customer1,1234500001,c1@gmail.com,1,Savings ,Customer_Address1,Branch1,BARB0IFSC1,MICR1,Branch_Address1,14-02-2023,11:30:00,14-02-2023,Gift Shop Purchase,,2500.0,,195801.0
9,Customer1,1234500001,c1@gmail.com,1,Savings ,Customer_Address1,Branch1,BARB0IFSC1,MICR1,Branch_Address1,20-02-2023,14:00:00,20-02-2023,Gas Bill Payment,,850.0,,194951.0
10,Customer1,1234500001,c1@gmail.com,1,Savings ,Customer_Address1,Branch1,BARB0IFSC1,MICR1,Branch_Address1,26-02-2023,17:30:00,26-02-2023,Movie Tickets,,600.0,,194351.0
11,Customer1,1234500001,c1@gmail.com,1,Savings ,Customer_Address1,Branch1,BARB0IFSC1,MICR1,Branch_Address1,28-02-2023,9:30:00,28-02-2023,Salary Credit,,,65000.0,259351.0
12,Customer1,1234500001,c1@gmail.com,1,Savings ,Customer_Address1,Branch1,BARB0IFSC1,MICR1,Branch_Address1,05-03-2023,10:45:00,05-03-2023,Health Insurance Premium,,12000.0,,247351.0
13,Customer1,1234500001,c1@gmail.com,1,Savings ,Customer_Address1,Branch1,BARB0IFSC1,MICR1,Branch_Address1,11-03-2023,16:00:00,11-03-2023,Clothing Store Purchase,,4500.0,,242851.0
14,Customer1,1234500001,c1@gmail.com,1,Savings ,Customer_Address1,Branch1,BARB0IFSC1,MICR1,Branch_Address1,17-03-2023,12:30:00,17-03-2023,Internet Bill Payment,,1200.0,,241651.0
15,Customer1,1234500001,c1@gmail.com,1,Savings ,Customer_Address1,Branch1,BARB0IFSC1,MICR1,Branch_Address1,23-03-2023,14:15:00,23-03-2023,Pharmacy Purchase,,1800.0,,239851.0
16,Customer1,1234500001,c1@gmail.com,1,Savings ,Customer_Address1,Branch1,BARB0IFSC1,MICR1,Branch_Address1,28-03-2023,9:30:00,28-03-2023,Salary Credit,,,65000.0,304851.0
17,Customer1,1234500001,c1@gmail.com,1,Savings ,Customer_Address1,Branch1,BARB0IFSC1,MICR1,Branch_Address1,31-03-2023,23:59:59,31-03-2023,Quarterly Interest Credit,,,3048.51,307899.51
18,Customer1,1234500001,c1@gmail.com,1,Savings ,Customer_Address1,Branch1,BARB0IFSC1,MICR1,Branch_Address1,04-04-2023,11:00:00,04-04-2023,ATM Withdrawal,,10000.0,,297899.51
19,Customer1,1234500001,c1@gmail.com,1,Savings ,Customer_Address1,Branch1,BARB0IFSC1,MICR1,Branch_Address1,09-04-2023,13:30:00,09-04-2023,Restaurant Payment,,2200.0,,295699.51
20,Customer1,1234500001,c1@gmail.com,1,Savings ,Customer_Address1,Branch1,BARB0IFSC1,MICR1,Branch_Address1,16-04-2023,15:45:00,16-04-2023,Electricity Bill Payment,,2400.0,,293299.51
21,Customer1,1234500001,c1@gmail.com,1,Savings ,Customer_Address1,Branch1,BARB0IFSC1,MICR1,Branch_Address1,21-04-2023,10:30:00,21-04-2023,Online Shopping - Flipkart,,5500.0,,287799.51
22,Customer1,1234500001,c1@gmail.com,1,Savings ,Customer_Address1,Branch1,BARB0IFSC1,MICR1,Branch_Address1,28-04-2023,9:30:00,28-04-2023,Salary Credit,,,65000.0,352799.51
23,Customer1,1234500001,c1@gmail.com,1,Savings ,Customer_Address1,Branch1,BARB0IFSC1,MICR1,Branch_Address1,03-05-2023,14:00:00,03-05-2023,Grocery Shopping,,3800.0,,348999.51
24,Customer1,1234500001,c1@gmail.com,1,Savings ,Customer_Address1,Branch1,BARB0IFSC1,MICR1,Branch_Address1,08-05-2023,16:30:00,08-05-2023,Mobile Recharge,,1499.0,,347500.51
25,Customer1,1234500001,c1@gmail.com,1,Savings ,Customer_Address1,Branch1,BARB0IFSC1,MICR1,Branch_Address1,14-05-2023,11:15:00,14-05-2023,Home Appliance Purchase,,15000.0,,332500.51
26,Customer1,1234500001,c1@gmail.com,1,Savings ,Customer_Address1,Branch1,BARB0IFSC1,MICR1,Branch_Address1,19-05-2023,13:45:00,19-05-2023,Gas Bill Payment,,900.0,,331600.51
27,Customer1,1234500001,c1@gmail.com,1,Savings ,Customer_Address1,Branch1,BARB0IFSC1,MICR1,Branch_Address1,26-05-2023,17:00:00,26-05-2023,Book Store Purchase,,1200.0,,330400.51
28,Customer1,1234500001,c1@gmail.com,1,Savings ,Customer_Address1,Branch1,BARB0IFSC1,MICR1,Branch_Address1,28-05-2023,9:30:00,28-05-2023,Salary Credit,,,65000.0,395400.51
29,Customer1,1234500001,c1@gmail.com,1,Savings ,Customer_Address1,Branch1,BARB0IFSC1,MICR1,Branch_Address1,02-06-2023,10:30:00,02-06-2023,Health Insurance Premium,,12000.0,,383400.51
30,Customer1,1234500001,c1@gmail.com,1,Savings ,Customer_Address1,Branch1,BARB0IFSC1,MICR1,Branch_Address1,07-06-2023,15:15:00,07-06-2023,Clothing Store Purchase,,3800.0,,379600.51
31,Customer1,1234500001,c1@gmail.com,1,Savings ,Customer_Address1,Branch1,BARB0IFSC1,MICR1,Branch_Address1,13-06-2023,12:00:00,13-06-2023,Internet Bill Payment,,1200.0,,378400.51
32,Customer1,1234500001,c1@gmail.com,1,Savings ,Customer_Address1,Branch1,BARB0IFSC1,MICR1,Branch_Address1,18-06-2023,14:30:00,18-06-2023,Pharmacy Purchase,,2200.0,,376200.51
33,Customer1,1234500001,c1@gmail.com,1,Savings ,Customer_Address1,Branch1,BARB0IFSC1,MICR1,Branch_Address1,24-06-2023,16:45:00,24-06-2023,Restaurant Payment,,2500.0,,373700.51
34,Customer1,1234500001,c1@gmail.com,1,Savings ,Customer_Address1,Branch1,BARB0IFSC1,MICR1,Branch_Address1,28-06-2023,9:30:00,28-06-2023,Salary Credit,,,65000.0,438700.51
35,Customer1,1234500001,c1@gmail.com,1,Savings ,Customer_Address1,Branch1,BARB0IFSC1,MICR1,Branch_Address1,30-06-2023,23:59:59,30-06-2023,Quarterly Interest Credit,,,4387.01,443087.52
36,Customer1,1234500001,c1@gmail.com,1,Savings ,Customer_Address1,Branch1,BARB0IFSC1,MICR1,Branch_Address1,05-07-2023,11:30:00,05-07-2023,ATM Withdrawal,,8000.0,,435087.52
37,Customer1,1234500001,c1@gmail.com,1,Savings ,Customer_Address1,Branch1,BARB0IFSC1,MICR1,Branch_Address1,11-07-2023,13:00:00,11-07-2023,Online Shopping - Myntra,,4500.0,,430587.52
38,Customer1,1234500001,c1@gmail.com,1,Savings ,Customer_Address1,Branch1,BARB0IFSC1,MICR1,Branch_Address1,16-07-2023,15:30:00,16-07-2023,Electricity Bill Payment,,2600.0,,427987.52
39,Customer1,1234500001,c1@gmail.com,1,Savings ,Customer_Address1,Branch1,BARB0IFSC1,MICR1,Branch_Address1,21-07-2023,10:00:00,21-07-2023,Movie Tickets,,800.0,,427187.52
40,Customer1,1234500001,c1@gmail.com,1,Savings ,Customer_Address1,Branch1,BARB0IFSC1,MICR1,Branch_Address1,28-07-2023,9:30:00,28-07-2023,Salary Credit,,,65000.0,492187.52
41,Customer1,1234500001,c1@gmail.com,1,Savings ,Customer_Address1,Branch1,BARB0IFSC1,MICR1,Branch_Address1,03-08-2023,14:15:00,03-08-2023,Grocery Shopping,,4200.0,,487987.52
42,Customer1,1234500001,c1@gmail.com,1,Savings ,Customer_Address1,Branch1,BARB0IFSC1,MICR1,Branch_Address1,08-08-2023,16:00:00,08-08-2023,Mobile Recharge,,1299.0,,486688.52
43,Customer1,1234500001,c1@gmail.com,1,Savings ,Customer_Address1,Branch1,BARB0IFSC1,MICR1,Branch_Address1,14-08-2023,11:45:00,14-08-2023,Home 12or Purchase,,8500.0,,478188.52
44,Customer1,1234500001,c1@gmail.com,1,Savings ,Customer_Address1,Branch1,BARB0IFSC1,MICR1,Branch_Address1,19-08-2023,13:30:00,19-08-2023,Gas Bill Payment,,950.0,,477238.52
45,Customer1,1234500001,c1@gmail.com,1,Savings ,Customer_Address1,Branch1,BARB0IFSC1,MICR1,Branch_Address1,25-08-2023,17:15:00,25-08-2023,Gym Membership Fee,,6000.0,,471238.52
46,Customer1,1234500001,c1@gmail.com,1,Savings ,Customer_Address1,Branch1,BARB0IFSC1,MICR1,Branch_Address1,28-08-2023,9:30:00,28-08-2023,Salary Credit,,,65000.0,536238.52
47,Customer1,1234500001,c1@gmail.com,1,Savings ,Customer_Address1,Branch1,BARB0IFSC1,MICR1,Branch_Address1,02-09-2023,10:45:00,02-09-2023,Health Insurance Premium,,12000.0,,524238.52
48,Customer1,1234500001,c1@gmail.com,1,Savings ,Customer_Address1,Branch1,BARB0IFSC1,MICR1,Branch_Address1,07-09-2023,15:30:00,07-09-2023,Clothing Store Purchase,,5200.0,,519038.52
49,Customer1,1234500001,c1@gmail.com,1,Savings ,Customer_Address1,Branch1,BARB0IFSC1,MICR1,Branch_Address1,13-09-2023,12:15:00,13-09-2023,Internet Bill Payment,,1200.0,,517838.52
50,Customer1,1234500001,c1@gmail.com,1,Savings ,Customer_Address1,Branch1,BARB0IFSC1,MICR1,Branch_Address1,18-09-2023,14:45:00,18-09-2023,Pharmacy Purchase,,1600.0,,516238.52
51,Customer1,1234500001,c1@gmail.com,1,Savings ,Customer_Address1,Branch1,BARB0IFSC1,MICR1,Branch_Address1,24-09-2023,16:30:00,24-09-2023,Restaurant Payment,,3000.0,,513238.52
52,Customer1,1234500001,c1@gmail.com,1,Savings ,Customer_Address1,Branch1,BARB0IFSC1,MICR1,Branch_Address1,28-09-2023,9:30:00,28-09-2023,Salary Credit,,,65000.0,578238.52
53,Customer1,1234500001,c1@gmail.com,1,Savings ,Customer_Address1,Branch1,BARB0IFSC1,MICR1,Branch_Address1,30-09-2023,23:59:59,30-09-2023,Quarterly Interest Credit,,,5782.39,584020.91
54,Customer1,1234500001,c1@gmail.com,1,Savings ,Customer_Address1,Branch1,BARB0IFSC1,MICR1,Branch_Address1,04-10-2023,11:15:00,04-10-2023,ATM Withdrawal,,12000.0,,572020.91
55,Customer1,1234500001,c1@gmail.com,1,Savings ,Customer_Address1,Branch1,BARB0IFSC1,MICR1,Branch_Address1,09-10-2023,13:45:00,09-10-2023,Online Shopping - Amazon,,6500.0,,565520.91
56,Customer1,1234500001,c1@gmail.com,1,Savings ,Customer_Address1,Branch1,BARB0IFSC1,MICR1,Branch_Address1,15-10-2023,15:00:00,15-10-2023,Electricity Bill Payment,,2800.0,,562720.91
57,Customer1,1234500001,c1@gmail.com,1,Savings ,Customer_Address1,Branch1,BARB0IFSC1,MICR1,Branch_Address1,20-10-2023,10:30:00,20-10-2023,Car Service,,7500.0,,555220.91
58,Customer1,1234500001,c1@gmail.com,1,Savings ,Customer_Address1,Branch1,BARB0IFSC1,MICR1,Branch_Address1,28-10-2023,9:30:00,28-10-2023,Salary Credit,,,65000.0,620220.91
59,Customer1,1234500001,c1@gmail.com,1,Savings ,Customer_Address1,Branch1,BARB0IFSC1,MICR1,Branch_Address1,02-11-2023,14:30:00,02-11-2023,Grocery Shopping,,4500.0,,615720.91
60,Customer1,1234500001,c1@gmail.com,1,Savings ,Customer_Address1,Branch1,BARB0IFSC1,MICR1,Branch_Address1,07-11-2023,16:15:00,07-11-2023,Mobile Recharge,,1599.0,,614121.91
61,Customer1,1234500001,c1@gmail.com,1,Savings ,Customer_Address1,Branch1,BARB0IFSC1,MICR1,Branch_Address1,13-11-2023,11:00:00,13-11-2023,Furniture Purchase,,25000.0,,589121.91
62,Customer1,1234500001,c1@gmail.com,1,Savings ,Customer_Address1,Branch1,BARB0IFSC1,MICR1,Branch_Address1,18-11-2023,13:15:00,18-11-2023,Gas Bill Payment,,1000.0,,588121.91
63,Customer1,1234500001,c1@gmail.com,1,Savings ,Customer_Address1,Branch1,BARB0IFSC1,MICR1,Branch_Address1,24-11-2023,17:30:00,24-11-2023,Book Store Purchase,,1800.0,,586321.91
64,Customer1,1234500001,c1@gmail.com,1,Savings ,Customer_Address1,Branch1,BARB0IFSC1,MICR1,Branch_Address1,28-11-2023,9:30:00,28-11-2023,Salary Credit,,,65000.0,651321.91
65,Customer1,1234500001,c1@gmail.com,1,Savings ,Customer_Address1,Branch1,BARB0IFSC1,MICR1,Branch_Address1,03-12-2023,10:00:00,03-12-2023,Health Insurance Premium,,12000.0,,639321.91
66,Customer1,1234500001,c1@gmail.com,1,Savings ,Customer_Address1,Branch1,BARB0IFSC1,MICR1,Branch_Address1,08-12-2023,15:45:00,08-12-2023,Clothing Store Purchase,,7000.0,,632321.91
67,Customer1,1234500001,c1@gmail.com,1,Savings ,Customer_Address1,Branch1,BARB0IFSC1,MICR1,Branch_Address1,14-12-2023,12:30:00,14-12-2023,Internet Bill Payment,,1200.0,,631121.91
68,Customer1,1234500001,c1@gmail.com,1,Savings ,Customer_Address1,Branch1,BARB0IFSC1,MICR1,Branch_Address1,19-12-2023,14:00:00,19-12-2023,Pharmacy Purchase,,2500.0,,628621.91
69,Customer1,1234500001,c1@gmail.com,1,Savings ,Customer_Address1,Branch1,BARB0IFSC1,MICR1,Branch_Address1,25-12-2023,16:45:00,25-12-2023,Restaurant Payment,,3500.0,,625121.91
70,Customer1,1234500001,c1@gmail.com,1,Savings ,Customer_Address1,Branch1,BARB0IFSC1,MICR1,Branch_Address1,28-12-2023,9:30:00,28-12-2023,Salary Credit,,,65000.0,690121.91
71,Customer1,1234500001,c1@gmail.com,1,Savings ,Customer_Address1,Branch1,BARB0IFSC1,MICR1,Branch_Address1,31-12-2023,23:59:59,31-12-2023,Quarterly Interest Credit,,,6901.22,697023.13
72,Customer1,1234500001,c1@gmail.com,1,Savings ,Customer_Address1,Branch1,BARB0IFSC1,MICR1,Branch_Address1,05-01-2024,11:45:00,05-01-2024,ATM Withdrawal,,15000.0,,682023.13
73,Customer1,1234500001,c1@gmail.com,1,Savings ,Customer_Address1,Branch1,BARB0IFSC1,MICR1,Branch_Address1,11-01-2024,13:30:00,11-01-2024,Online Shopping - Flipkart,,8000.0,,674023.13
74,Customer1,1234500001,c1@gmail.com,1,Savings ,Customer_Address1,Branch1,BARB0IFSC1,MICR1,Branch_Address1,17-01-2024,15:15:00,17-01-2024,Electricity Bill Payment,,3000.0,,671023.13
75,Customer1,1234500001,c1@gmail.com,1,Savings ,Customer_Address1,Branch1,BARB0IFSC1,MICR1,Branch_Address1,22-01-2024,10:45:00,22-01-2024,Movie Tickets,,1000.0,,670023.13
76,Customer1,1234500001,c1@gmail.com,1,Savings ,Customer_Address1,Branch1,BARB0IFSC1,MICR1,Branch_Address1,28-01-2024,9:30:00,28-01-2024,Salary Credit,,,65000.0,735023.13
77,Customer1,1234500001,c1@gmail.com,1,Savings ,Customer_Address1,Branch1,BARB0IFSC1,MICR1,Branch_Address1,02-02-2024,14:00:00,02-02-2024,Grocery Shopping,,5000.0,,730023.13
78,Customer1,1234500001,c1@gmail.com,1,Savings ,Customer_Address1,Branch1,BARB0IFSC1,MICR1,Branch_Address1,07-02-2024,16:30:00,07-02-2024,Mobile Recharge,,1799.0,,728224.13
79,Customer1,1234500001,c1@gmail.com,1,Savings ,Customer_Address1,Branch1,BARB0IFSC1,MICR1,Branch_Address1,13-02-2024,11:15:00,13-02-2024,Gift Shop Purchase,,4000.0,,724224.13
80,Customer1,1234500001,c1@gmail.com,1,Savings ,Customer_Address1,Branch1,BARB0IFSC1,MICR1,Branch_Address1,18-02-2024,13:45:00,18-02-2024,Gas Bill Payment,,1050.0,,723174.13
81,Customer1,1234500001,c1@gmail.com,1,Savings ,Customer_Address1,Branch1,BARB0IFSC1,MICR1,Branch_Address1,24-02-2024,17:00:00,24-02-2024,Gym Membership Fee,,6000.0,,717174.13
82,Customer1,1234500001,c1@gmail.com,1,Savings ,Customer_Address1,Branch1,BARB0IFSC1,MICR1,Branch_Address1,28-02-2024,9:30:00,28-02-2024,Salary Credit,,,65000.0,782174.13
83,Customer1,1234500001,c1@gmail.com,1,Savings ,Customer_Address1,Branch1,BARB0IFSC1,MICR1,Branch_Address1,04-03-2024,10:30:00,04-03-2024,Health Insurance Premium,,12000.0,,770174.13
84,Customer1,1234500001,c1@gmail.com,1,Savings ,Customer_Address1,Branch1,BARB0IFSC1,MICR1,Branch_Address1,09-03-2024,15:00:00,09-03-2024,Clothing Store Purchase,,6500.0,,763674.13
85,Customer1,1234500001,c1@gmail.com,1,Savings ,Customer_Address1,Branch1,BARB0IFSC1,MICR1,Branch_Address1,15-03-2024,12:45:00,15-03-2024,Internet Bill Payment,,1200.0,,762474.13
86,Customer1,1234500001,c1@gmail.com,1,Savings ,Customer_Address1,Branch1,BARB0IFSC1,MICR1,Branch_Address1,20-03-2024,14:15:00,20-03-2024,Pharmacy Purchase,,1800.0,,760674.13
87,Customer1,1234500001,c1@gmail.com,1,Savings ,Customer_Address1,Branch1,BARB0IFSC1,MICR1,Branch_Address1,26-03-2024,16:30:00,26-03-2024,Restaurant Payment,,3200.0,,757474.13
88,Customer1,1234500001,c1@gmail.com,1,Savings ,Customer_Address1,Branch1,BARB0IFSC1,MICR1,Branch_Address1,28-03-2024,9:30:00,28-03-2024,Salary Credit,,,65000.0,822474.13
89,Customer1,1234500001,c1@gmail.com,1,Savings ,Customer_Address1,Branch1,BARB0IFSC1,MICR1,Branch_Address1,31-03-2024,23:59:59,31-03-2024,Quarterly Interest Credit,,,8224.74,830698.87
90,Customer1,1234500001,c1@gmail.com,1,Savings ,Customer_Address1,Branch1,BARB0IFSC1,MICR1,Branch_Address1,04-04-2024,11:00:00,04-04-2024,ATM Withdrawal,,10000.0,,820698.87
91,Customer1,1234500001,c1@gmail.com,1,Savings ,Customer_Address1,Branch1,BARB0IFSC1,MICR1,Branch_Address1,09-04-2024,13:15:00,09-04-2024,Online Shopping - Myntra,,7500.0,,813198.87
92,Customer1,1234500001,c1@gmail.com,1,Savings ,Customer_Address1,Branch1,BARB0IFSC1,MICR1,Branch_Address1,15-04-2024,15:30:00,15-04-2024,Electricity Bill Payment,,3200.0,,809998.87
93,Customer1,1234500001,c1@gmail.com,1,Savings ,Customer_Address1,Branch1,BARB0IFSC1,MICR1,Branch_Address1,20-04-2024,10:15:00,20-04-2024,Car Insurance Premium,,15000.0,,794998.87
94,Customer1,1234500001,c1@gmail.com,1,Savings ,Customer_Address1,Branch1,BARB0IFSC1,MICR1,Branch_Address1,28-04-2024,9:30:00,28-04-2024,Salary Credit,,,65000.0,859998.87
95,Customer1,1234500001,c1@gmail.com,1,Savings ,Customer_Address1,Branch1,BARB0IFSC1,MICR1,Branch_Address1,03-05-2024,14:45:00,03-05-2024,Grocery Shopping,,5500.0,,854498.87
96,Customer1,1234500001,c1@gmail.com,1,Savings ,Customer_Address1,Branch1,BARB0IFSC1,MICR1,Branch_Address1,08-05-2024,16:00:00,08-05-2024,Mobile Recharge,,1999.0,,852499.87
97,Customer1,1234500001,c1@gmail.com,1,Savings ,Customer_Address1,Branch1,BARB0IFSC1,MICR1,Branch_Address1,14-05-2024,11:30:00,14-05-2024,Home Appliance Purchase,,20000.0,,832499.87
98,Customer1,1234500001,c1@gmail.com,1,Savings ,Customer_Address1,Branch1,BARB0IFSC1,MICR1,Branch_Address1,19-05-2024,13:00:00,19-05-2024,Gas Bill Payment,,1100.0,,831399.87
99,Customer1,1234500001,c1@gmail.com,1,Savings ,Customer_Address1,Branch1,BARB0IFSC1,MICR1,Branch_Address1,25-05-2024,17:15:00,25-05-2024,Book Store Purchase,,2000.0,,829399.87
99,Customer1,1234500001,c1@gmail.com,1,Savings ,Customer_Address1,Branch1,BARB0IFSC1,MICR1,Branch_Address1,25-05-2024,17:15:00,25-05-2024,Fixed Deposit,,820000.0,,9399.87
100,Customer1,1234500001,c1@gmail.com,1,Savings ,Customer_Address1,Branch1,BARB0IFSC1,MICR1,Branch_Address1,28-05-2024,9:30:00,28-05-2024,Salary Credit,,,65000.0,894399.87
101,Customer1,1234500001,c1@gmail.com,1,Savings ,Customer_Address1,Branch1,BARB0IFSC1,MICR1,Branch_Address1,02-06-2024,10:45:00,02-06-2024,Health Insurance Premium,,12000.0,,882399.87
102,Customer1,1234500001,c1@gmail.com,1,Savings ,Customer_Address1,Branch1,BARB0IFSC1,MICR1,Branch_Address1,07-06-2024,15:30:00,07-06-2024,Clothing Store Purchase,,8000.0,,874399.9
103,Customer1,1234500001,c1@gmail.com,1,Savings ,Customer_Address1,Branch1,BARB0IFSC1,MICR1,Branch_Address1,12-06-2024,12:00:00,12-06-2024,Restaurant Bill,,3500.0,,870899.87
104,Customer1,1234500001,c1@gmail.com,1,Savings ,Customer_Address1,Branch1,BARB0IFSC1,MICR1,Branch_Address1,18-06-2024,14:30:00,18-06-2024,Internet Bill Payment,,1800.0,,869099.87
105,Customer1,1234500001,c1@gmail.com,1,Savings ,Customer_Address1,Branch1,BARB0IFSC1,MICR1,Branch_Address1,23-06-2024,16:45:00,23-06-2024,Movie Tickets,,1000.0,,868099.87
106,Customer1,1234500001,c1@gmail.com,1,Savings ,Customer_Address1,Branch1,BARB0IFSC1,MICR1,Branch_Address1,28-06-2024,9:30:00,28-06-2024,Salary Credit,,,65000.0,933099.87
107,Customer1,1234500001,c1@gmail.com,1,Savings ,Customer_Address1,Branch1,BARB0IFSC1,MICR1,Branch_Address1,30-06-2024,23:59:59,30-06-2024,Quarterly Interest Credit,,,9330.99,942430.86
108,Customer1,1234500001,c1@gmail.com,1,Savings ,Customer_Address1,Branch1,BARB0IFSC1,MICR1,Branch_Address1,05-07-2024,11:15:00,05-07-2024,Super03ket Purchase,,7500.0,,934930.86
109,Customer1,1234500001,c1@gmail.com,1,Savings ,Customer_Address1,Branch1,BARB0IFSC1,MICR1,Branch_Address1,10-07-2024,13:30:00,10-07-2024,Gym Membership Renewal,,12000.0,,922930.86
110,Customer1,1234500001,c1@gmail.com,1,Savings ,Customer_Address1,Branch1,BARB0IFSC1,MICR1,Branch_Address1,16-07-2024,15:00:00,16-07-2024,Electricity Bill Payment,,3500.0,,919430.86
111,Customer1,1234500001,c1@gmail.com,1,Savings ,Customer_Address1,Branch1,BARB0IFSC1,MICR1,Branch_Address1,21-07-2024,10:30:00,21-07-2024,Online Course Subscription,,5000.0,,914430.86
112,Customer1,1234500001,c1@gmail.com,1,Savings ,Customer_Address1,Branch1,BARB0IFSC1,MICR1,Branch_Address1,26-07-2024,14:15:00,26-07-2024,Fuel Purchase,,2000.0,,912430.86
113,Customer1,1234500001,c1@gmail.com,1,Savings ,Customer_Address1,Branch1,BARB0IFSC1,MICR1,Branch_Address1,28-07-2024,9:30:00,28-07-2024,Salary Credit,,,65000.0,977430.86
114,Customer1,1234500001,c1@gmail.com,1,Savings ,Customer_Address1,Branch1,BARB0IFSC1,MICR1,Branch_Address1,31-07-2024,17:00:00,31-07-2024,Cheque Deposit,123456.0,,15000.0,992430.86
115,Customer2,1234500002,c2@gmail.com,2,Savings ,Customer_Address2,Branch2,BARB0IFSC2,MICR2,Branch_Address2,15-01-2024,9:30:00,15-01-2024,Cash Deposit,,,50000.0,50000.0
116,Customer2,1234500002,c2@gmail.com,2,Savings ,Customer_Address2,Branch2,BARB0IFSC2,MICR2,Branch_Address2,18-01-2024,14:45:00,18-01-2024,ATM Withdrawal,,5000.0,,45000.0
117,Customer2,1234500002,c2@gmail.com,2,Savings ,Customer_Address2,Branch2,BARB0IFSC2,MICR2,Branch_Address2,22-01-2024,11:20:00,22-01-2024,Online Shopping - Amazon,,2500.0,,42500.0
118,Customer2,1234500002,c2@gmail.com,2,Savings ,Customer_Address2,Branch2,BARB0IFSC2,MICR2,Branch_Address2,25-01-2024,10:00:00,25-01-2024,Salary Credit,,,65000.0,107500.0
119,Customer2,1234500002,c2@gmail.com,2,Savings ,Customer_Address2,Branch2,BARB0IFSC2,MICR2,Branch_Address2,28-01-2024,16:30:00,28-01-2024,Electricity Bill Payment,,1800.0,,105700.0
120,Customer2,1234500002,c2@gmail.com,2,Savings ,Customer_Address2,Branch2,BARB0IFSC2,MICR2,Branch_Address2,02-02-2024,13:15:00,02-02-2024,Grocery Shopping,,3500.0,,102200.0
121,Customer2,1234500002,c2@gmail.com,2,Savings ,Customer_Address2,Branch2,BARB0IFSC2,MICR2,Branch_Address2,07-02-2024,9:45:00,07-02-2024,Mobile Recharge,,999.0,,101201.0
122,Customer2,1234500002,c2@gmail.com,2,Savings ,Customer_Address2,Branch2,BARB0IFSC2,MICR2,Branch_Address2,15-02-2024,11:30:00,15-02-2024,SIP Investment,,5000.0,,96201.0
123,Customer2,1234500002,c2@gmail.com,2,Savings ,Customer_Address2,Branch2,BARB0IFSC2,MICR2,Branch_Address2,20-02-2024,14:00:00,20-02-2024,Restaurant Bill,,2800.0,,93401.0
124,Customer2,1234500002,c2@gmail.com,2,Savings ,Customer_Address2,Branch2,BARB0IFSC2,MICR2,Branch_Address2,25-02-2024,10:00:00,25-02-2024,Salary Credit,,,65000.0,158401.0
125,Customer2,1234500002,c2@gmail.com,2,Savings ,Customer_Address2,Branch2,BARB0IFSC2,MICR2,Branch_Address2,29-02-2024,16:45:00,29-02-2024,Electricity Bill Payment,,1750.0,,156651.0
126,Customer2,1234500002,c2@gmail.com,2,Savings ,Customer_Address2,Branch2,BARB0IFSC2,MICR2,Branch_Address2,05-03-2024,12:30:00,05-03-2024,Fuel Refill,,2000.0,,154651.0
127,Customer2,1234500002,c2@gmail.com,2,Savings ,Customer_Address2,Branch2,BARB0IFSC2,MICR2,Branch_Address2,10-03-2024,15:20:00,10-03-2024,Movie Tickets,,800.0,,153851.0
128,Customer2,1234500002,c2@gmail.com,2,Savings ,Customer_Address2,Branch2,BARB0IFSC2,MICR2,Branch_Address2,15-03-2024,11:30:00,15-03-2024,SIP Investment,,5000.0,,148851.0
129,Customer2,1234500002,c2@gmail.com,2,Savings ,Customer_Address2,Branch2,BARB0IFSC2,MICR2,Branch_Address2,20-03-2024,9:15:00,20-03-2024,Medical Expenses,,3500.0,,145351.0
130,Customer2,1234500002,c2@gmail.com,2,Savings ,Customer_Address2,Branch2,BARB0IFSC2,MICR2,Branch_Address2,25-03-2024,10:00:00,25-03-2024,Salary Credit,,,65000.0,210351.0
131,Customer2,1234500002,c2@gmail.com,2,Savings ,Customer_Address2,Branch2,BARB0IFSC2,MICR2,Branch_Address2,31-03-2024,23:59:00,31-03-2024,Quarterly Interest Credit,,,1668.0,212019.0
132,Customer2,1234500002,c2@gmail.com,2,Savings ,Customer_Address2,Branch2,BARB0IFSC2,MICR2,Branch_Address2,03-04-2024,14:30:00,03-04-2024,Online Shopping - Flipkart,,4500.0,,207519.0
133,Customer2,1234500002,c2@gmail.com,2,Savings ,Customer_Address2,Branch2,BARB0IFSC2,MICR2,Branch_Address2,08-04-2024,11:00:00,08-04-2024,Insurance Premium,,12000.0,,195519.0
134,Customer2,1234500002,c2@gmail.com,2,Savings ,Customer_Address2,Branch2,BARB0IFSC2,MICR2,Branch_Address2,15-04-2024,11:30:00,15-04-2024,SIP Investment,,5000.0,,190519.0
135,Customer2,1234500002,c2@gmail.com,2,Savings ,Customer_Address2,Branch2,BARB0IFSC2,MICR2,Branch_Address2,20-04-2024,16:15:00,20-04-2024,Electricity Bill Payment,,1900.0,,188619.0
136,Customer2,1234500002,c2@gmail.com,2,Savings ,Customer_Address2,Branch2,BARB0IFSC2,MICR2,Branch_Address2,25-04-2024,10:00:00,25-04-2024,Salary Credit,,,65000.0,253619.0
137,Customer2,1234500002,c2@gmail.com,2,Savings ,Customer_Address2,Branch2,BARB0IFSC2,MICR2,Branch_Address2,30-04-2024,13:45:00,30-04-2024,Cheque Deposit,123456.0,,25000.0,278619.0
138,Customer2,1234500002,c2@gmail.com,2,Savings ,Customer_Address2,Branch2,BARB0IFSC2,MICR2,Branch_Address2,05-05-2024,9:30:00,05-05-2024,ATM Withdrawal,,10000.0,,268619.0
139,Customer2,1234500002,c2@gmail.com,2,Savings ,Customer_Address2,Branch2,BARB0IFSC2,MICR2,Branch_Address2,12-05-2024,14:20:00,12-05-2024,Home Appliance Purchase,,15000.0,,253619.0
140,Customer2,1234500002,c2@gmail.com,2,Savings ,Customer_Address2,Branch2,BARB0IFSC2,MICR2,Branch_Address2,15-05-2024,11:30:00,15-05-2024,SIP Investment,,5000.0,,248619.0
141,Customer2,1234500002,c2@gmail.com,2,Savings ,Customer_Address2,Branch2,BARB0IFSC2,MICR2,Branch_Address2,22-05-2024,16:00:00,22-05-2024,Electricity Bill Payment,,1850.0,,246769.0
142,Customer2,1234500002,c2@gmail.com,2,Savings ,Customer_Address2,Branch2,BARB0IFSC2,MICR2,Branch_Address2,25-05-2024,10:00:00,25-05-2024,Salary Credit,,,65000.0,311769.0
143,Customer2,1234500002,c2@gmail.com,2,Savings ,Customer_Address2,Branch2,BARB0IFSC2,MICR2,Branch_Address2,01-06-2024,12:15:00,01-06-2024,Mobile Phone Purchase,,20000.0,,291769.0
144,Customer2,1234500002,c2@gmail.com,2,Savings ,Customer_Address2,Branch2,BARB0IFSC2,MICR2,Branch_Address2,08-06-2024,15:30:00,08-06-2024,Restaurant Bill,,3500.0,,288269.0
145,Customer2,1234500002,c2@gmail.com,2,Savings ,Customer_Address2,Branch2,BARB0IFSC2,MICR2,Branch_Address2,15-06-2024,11:30:00,15-06-2024,SIP Investment,,5000.0,,283269.0
146,Customer2,1234500002,c2@gmail.com,2,Savings ,Customer_Address2,Branch2,BARB0IFSC2,MICR2,Branch_Address2,20-06-2024,9:45:00,20-06-2024,Grocery Shopping,,4000.0,,279269.0
147,Customer2,1234500002,c2@gmail.com,2,Savings ,Customer_Address2,Branch2,BARB0IFSC2,MICR2,Branch_Address2,25-06-2024,10:00:00,25-06-2024,Salary Credit,,,65000.0,344269.0
148,Customer2,1234500002,c2@gmail.com,2,Savings ,Customer_Address2,Branch2,BARB0IFSC2,MICR2,Branch_Address2,28-06-2024,16:30:00,28-06-2024,Electricity Bill Payment,,2100.0,,342169.0
149,Customer2,1234500002,c2@gmail.com,2,Savings ,Customer_Address2,Branch2,BARB0IFSC2,MICR2,Branch_Address2,30-06-2024,23:59:00,30-06-2024,Quarterly Interest Credit,,,3368.0,345537.0
150,Customer2,1234500002,c2@gmail.com,2,Savings ,Customer_Address2,Branch2,BARB0IFSC2,MICR2,Branch_Address2,05-07-2024,22:15:00,05-07-2024,Online Shopping - Myntra,,26983.0,,318554.0
151,Customer2,1234500002,c2@gmail.com,2,Savings ,Customer_Address2,Branch2,BARB0IFSC2,MICR2,Branch_Address2,10-07-2024,11:00:00,10-07-2024,Fuel Refill,,2500.0,,316054.0
152,Customer2,1234500002,c2@gmail.com,2,Savings ,Customer_Address2,Branch2,BARB0IFSC2,MICR2,Branch_Address2,15-07-2024,11:30:00,15-07-2024,SIP Investment,,5000.0,,311054.0
153,Customer2,1234500002,c2@gmail.com,2,Savings ,Customer_Address2,Branch2,BARB0IFSC2,MICR2,Branch_Address2,20-07-2024,16:45:00,20-07-2024,Movie Tickets,,1000.0,,310054.0
154,Customer2,1234500002,c2@gmail.com,2,Savings ,Customer_Address2,Branch2,BARB0IFSC2,MICR2,Branch_Address2,25-07-2024,10:00:00,25-07-2024,Salary Credit,,,65000.0,375054.0
155,Customer2,1234500002,c2@gmail.com,2,Savings ,Customer_Address2,Branch2,BARB0IFSC2,MICR2,Branch_Address2,30-07-2024,13:30:00,30-07-2024,Electricity Bill Payment,,2050.0,,373004.0
156,Customer2,1234500002,c2@gmail.com,2,Savings ,Customer_Address2,Branch2,BARB0IFSC2,MICR2,Branch_Address2,31-07-2024,22:17:00,31-07-2024,Online Shopping - Flipkart,,4500.0,,368504.0
157,Customer2,1234500002,c2@gmail.com,2,Savings ,Customer_Address2,Branch2,BARB0IFSC2,MICR2,Branch_Address2,31-07-2024,22:18:00,31-07-2024,Online Shopping - Nayka,,5400.0,,363104.0
158,Customer2,1234500002,c2@gmail.com,2,Savings ,Customer_Address2,Branch2,BARB0IFSC2,MICR2,Branch_Address2,31-07-2024,22:20:00,31-07-2024,Online Shopping - Amazon,,2800.0,,360304.0
159,Customer2,1234500002,c2@gmail.com,2,Savings ,Customer_Address2,Branch2,BARB0IFSC2,MICR2,Branch_Address2,31-07-2024,22:22:00,31-07-2024,Online Shopping - Amazon,,3660.0,,356644.0
160,Customer2,1234500002,c2@gmail.com,2,Savings ,Customer_Address2,Branch2,BARB0IFSC2,MICR2,Branch_Address2,31-07-2024,22:24:00,31-07-2024,Online Shopping - Amazon,,7123.0,,349521.0
161,Customer3,1234500003,c3@gmail.com,3,Savings ,Customer_Address3,Branch3,BARB0IFSC3,MICR3,Branch_Address3,05-04-2024,14:30:00,05-04-2024,Electricity Bill Payment,,2150.0,,147850.0
162,Customer3,1234500003,c3@gmail.com,3,Savings ,Customer_Address3,Branch3,BARB0IFSC3,MICR3,Branch_Address3,10-04-2024,11:45:00,10-04-2024,ATM Withdrawal,,5000.0,,142850.0
163,Customer3,1234500003,c3@gmail.com,3,Savings ,Customer_Address3,Branch3,BARB0IFSC3,MICR3,Branch_Address3,15-04-2024,16:20:00,15-04-2024,Online Shopping - Amazon,,3500.0,,139350.0
164,Customer3,1234500003,c3@gmail.com,3,Savings ,Customer_Address3,Branch3,BARB0IFSC3,MICR3,Branch_Address3,20-04-2024,10:00:00,20-04-2024,SIP Investment,,10000.0,,129350.0
165,Customer3,1234500003,c3@gmail.com,3,Savings ,Customer_Address3,Branch3,BARB0IFSC3,MICR3,Branch_Address3,25-04-2024,9:30:00,25-04-2024,Salary Credit,,,85000.0,214350.0
166,Customer3,1234500003,c3@gmail.com,3,Savings ,Customer_Address3,Branch3,BARB0IFSC3,MICR3,Branch_Address3,28-04-2024,13:15:00,28-04-2024,Grocery Shopping,,4500.0,,209850.0
167,Customer3,1234500003,c3@gmail.com,3,Savings ,Customer_Address3,Branch3,BARB0IFSC3,MICR3,Branch_Address3,03-05-2024,15:45:00,03-05-2024,Mobile Recharge,,999.0,,208851.0
168,Customer3,1234500003,c3@gmail.com,3,Savings ,Customer_Address3,Branch3,BARB0IFSC3,MICR3,Branch_Address3,08-05-2024,12:30:00,08-05-2024,Restaurant Bill,,2800.0,,206051.0
169,Customer3,1234500003,c3@gmail.com,3,Savings ,Customer_Address3,Branch3,BARB0IFSC3,MICR3,Branch_Address3,12-05-2024,17:00:00,12-05-2024,Movie Tickets,,1200.0,,204851.0
170,Customer3,1234500003,c3@gmail.com,3,Savings ,Customer_Address3,Branch3,BARB0IFSC3,MICR3,Branch_Address3,18-05-2024,10:30:00,18-05-2024,Gas Bill Payment,,850.0,,204001.0
171,Customer3,1234500003,c3@gmail.com,3,Savings ,Customer_Address3,Branch3,BARB0IFSC3,MICR3,Branch_Address3,20-05-2024,9:45:00,20-05-2024,SIP Investment,,10000.0,,194001.0
172,Customer3,1234500003,c3@gmail.com,3,Savings ,Customer_Address3,Branch3,BARB0IFSC3,MICR3,Branch_Address3,25-05-2024,9:30:00,25-05-2024,Salary Credit,,,85000.0,279001.0
173,Customer3,1234500003,c3@gmail.com,3,Savings ,Customer_Address3,Branch3,BARB0IFSC3,MICR3,Branch_Address3,30-05-2024,14:00:00,30-05-2024,Cheque Deposit,123456.0,,15000.0,294001.0
174,Customer3,1234500003,c3@gmail.com,3,Savings ,Customer_Address3,Branch3,BARB0IFSC3,MICR3,Branch_Address3,02-06-2024,11:20:00,02-06-2024,Car Insurance Premium,,12500.0,,281501.0
175,Customer3,1234500003,c3@gmail.com,3,Savings ,Customer_Address3,Branch3,BARB0IFSC3,MICR3,Branch_Address3,07-06-2024,16:15:00,07-06-2024,Online Course Fee,,8000.0,,273501.0
176,Customer3,1234500003,c3@gmail.com,3,Savings ,Customer_Address3,Branch3,BARB0IFSC3,MICR3,Branch_Address3,12-06-2024,13:45:00,12-06-2024,Clothing Purchase,,6500.0,,267001.0
177,Customer3,1234500003,c3@gmail.com,3,Savings ,Customer_Address3,Branch3,BARB0IFSC3,MICR3,Branch_Address3,17-06-2024,10:10:00,17-06-2024,Health Checkup,,3500.0,,263501.0
178,Customer3,1234500003,c3@gmail.com,3,Savings ,Customer_Address3,Branch3,BARB0IFSC3,MICR3,Branch_Address3,20-06-2024,9:50:00,20-06-2024,SIP Investment,,10000.0,,253501.0
179,Customer3,1234500003,c3@gmail.com,3,Savings ,Customer_Address3,Branch3,BARB0IFSC3,MICR3,Branch_Address3,25-06-2024,9:30:00,25-06-2024,Salary Credit,,,85000.0,338501.0
180,Customer3,1234500003,c3@gmail.com,3,Savings ,Customer_Address3,Branch3,BARB0IFSC3,MICR3,Branch_Address3,28-06-2024,15:30:00,28-06-2024,Flight Tickets,,18000.0,,320501.0
181,Customer3,1234500003,c3@gmail.com,3,Savings ,Customer_Address3,Branch3,BARB0IFSC3,MICR3,Branch_Address3,30-06-2024,23:59:59,30-06-2024,Quarterly Interest Credit,,,3205.01,323706.01
182,Customer3,1234500003,c3@gmail.com,3,Savings ,Customer_Address3,Branch3,BARB0IFSC3,MICR3,Branch_Address3,04-07-2024,12:00:00,04-07-2024,Property Tax Payment,,15000.0,,308706.01
183,Customer3,1234500003,c3@gmail.com,3,Savings ,Customer_Address3,Branch3,BARB0IFSC3,MICR3,Branch_Address3,09-07-2024,14:20:00,09-07-2024,Home Appliance Purchase,,22000.0,,286706.01
184,Customer3,1234500003,c3@gmail.com,3,Savings ,Customer_Address3,Branch3,BARB0IFSC3,MICR3,Branch_Address3,14-07-2024,11:30:00,14-07-2024,Charity Donation,,5000.0,,281706.01
185,Customer3,1234500003,c3@gmail.com,3,Savings ,Customer_Address3,Branch3,BARB0IFSC3,MICR3,Branch_Address3,18-07-2024,16:45:00,18-07-2024,Vehicle Servicing,,4500.0,,277206.01
186,Customer3,1234500003,c3@gmail.com,3,Savings ,Customer_Address3,Branch3,BARB0IFSC3,MICR3,Branch_Address3,20-07-2024,10:05:00,20-07-2024,SIP Investment,,10000.0,,267206.01
187,Customer3,1234500003,c3@gmail.com,3,Savings ,Customer_Address3,Branch3,BARB0IFSC3,MICR3,Branch_Address3,25-07-2024,9:30:00,25-07-2024,Salary Credit,,,85000.0,352206.01
188,Customer3,1234500003,c3@gmail.com,3,Savings ,Customer_Address3,Branch3,BARB0IFSC3,MICR3,Branch_Address3,29-07-2024,13:00:00,29-07-2024,Cheque Payment,789012.0,25000.0,,327206.01
189,Customer3,1234500003,c3@gmail.com,3,Savings ,Customer_Address3,Branch3,BARB0IFSC3,MICR3,Branch_Address3,31-07-2024,17:30:00,31-07-2024,Internet Bill Payment,,1499.0,,325707.01
190,Customer4,1234500004,c4@gmail.com,4,Savings ,Customer_Address4,Branch4,BARB0IFSC4,MICR4,Branch_Address4,18-06-2023,14:22:35,18-06-2023,ATM Withdrawal - HDFC Bank ATM Bandra,,5000.0,,45000.0
191,Customer4,1234500004,c4@gmail.com,4,Savings ,Customer_Address4,Branch4,BARB0IFSC4,MICR4,Branch_Address4,22-06-2023,10:15:42,22-06-2023,NEFT-Amazon Refund,,,1200.0,46200.0
192,Customer4,1234500004,c4@gmail.com,4,Savings ,Customer_Address4,Branch4,BARB0IFSC4,MICR4,Branch_Address4,25-06-2023,20:05:18,25-06-2023,UPI-Swiggy Food Order,,850.0,,45350.0
193,Customer4,1234500004,c4@gmail.com,4,Savings ,Customer_Address4,Branch4,BARB0IFSC4,MICR4,Branch_Address4,30-06-2023,11:00:00,30-06-2023,Salary Credit,,,65000.0,110350.0
194,Customer4,1234500004,c4@gmail.com,4,Savings ,Customer_Address4,Branch4,BARB0IFSC4,MICR4,Branch_Address4,02-07-2023,15:30:27,02-07-2023,Electricity Bill Payment-BEST,,2200.0,,108150.0
195,Customer4,1234500004,c4@gmail.com,4,Savings ,Customer_Address4,Branch4,BARB0IFSC4,MICR4,Branch_Address4,07-07-2023,9:45:13,07-07-2023,SIP Investment-ICICI Prudential,,5000.0,,103150.0
196,Customer4,1234500004,c4@gmail.com,4,Savings ,Customer_Address4,Branch4,BARB0IFSC4,MICR4,Branch_Address4,12-07-2023,16:20:55,12-07-2023,Mobile Recharge-Jio,,999.0,,102151.0
197,Customer4,1234500004,c4@gmail.com,4,Savings ,Customer_Address4,Branch4,BARB0IFSC4,MICR4,Branch_Address4,18-07-2023,11:35:40,18-07-2023,Cheque Deposit,123456.0,,15000.0,117151.0
198,Customer4,1234500004,c4@gmail.com,4,Savings ,Customer_Address4,Branch4,BARB0IFSC4,MICR4,Branch_Address4,24-07-2023,13:50:22,24-07-2023,POS Transaction-Shoppers Stop,,3500.0,,113651.0
199,Customer4,1234500004,c4@gmail.com,4,Savings ,Customer_Address4,Branch4,BARB0IFSC4,MICR4,Branch_Address4,30-07-2023,11:00:00,30-07-2023,Salary Credit,,,65000.0,178651.0
200,Customer4,1234500004,c4@gmail.com,4,Savings ,Customer_Address4,Branch4,BARB0IFSC4,MICR4,Branch_Address4,05-08-2023,14:15:30,05-08-2023,DTH Recharge-Tata Sky,,600.0,,178051.0
201,Customer4,1234500004,c4@gmail.com,4,Savings ,Customer_Address4,Branch4,BARB0IFSC4,MICR4,Branch_Address4,07-08-2023,9:45:13,07-08-2023,SIP Investment-ICICI Prudential,,5000.0,,173051.0
202,Customer4,1234500004,c4@gmail.com,4,Savings ,Customer_Address4,Branch4,BARB0IFSC4,MICR4,Branch_Address4,13-08-2023,18:30:45,13-08-2023,UPI-Zomato Food Order,,750.0,,172301.0
203,Customer4,1234500004,c4@gmail.com,4,Savings ,Customer_Address4,Branch4,BARB0IFSC4,MICR4,Branch_Address4,19-08-2023,10:25:18,19-08-2023,IMPS Transfer to Rahul,,10000.0,,162301.0
204,Customer4,1234500004,c4@gmail.com,4,Savings ,Customer_Address4,Branch4,BARB0IFSC4,MICR4,Branch_Address4,25-08-2023,16:40:33,25-08-2023,Amazon Shopping,,4500.0,,157801.0
205,Customer4,1234500004,c4@gmail.com,4,Savings ,Customer_Address4,Branch4,BARB0IFSC4,MICR4,Branch_Address4,30-08-2023,11:00:00,30-08-2023,Salary Credit,,,65000.0,222801.0
206,Customer4,1234500004,c4@gmail.com,4,Savings ,Customer_Address4,Branch4,BARB0IFSC4,MICR4,Branch_Address4,03-09-2023,12:10:25,03-09-2023,Electricity Bill Payment-BEST,,2350.0,,220451.0
207,Customer4,1234500004,c4@gmail.com,4,Savings ,Customer_Address4,Branch4,BARB0IFSC4,MICR4,Branch_Address4,07-09-2023,9:45:13,07-09-2023,SIP Investment-ICICI Prudential,,5000.0,,215451.0
208,Customer4,1234500004,c4@gmail.com,4,Savings ,Customer_Address4,Branch4,BARB0IFSC4,MICR4,Branch_Address4,14-09-2023,15:55:40,14-09-2023,Movie Tickets-BookMyShow,,1200.0,,214251.0
209,Customer4,1234500004,c4@gmail.com,4,Savings ,Customer_Address4,Branch4,BARB0IFSC4,MICR4,Branch_Address4,20-09-2023,11:30:18,20-09-2023,Cheque Payment,789012.0,25000.0,,189251.0
210,Customer4,1234500004,c4@gmail.com,4,Savings ,Customer_Address4,Branch4,BARB0IFSC4,MICR4,Branch_Address4,26-09-2023,17:20:55,26-09-2023,Flipkart Purchase,,3800.0,,185451.0
211,Customer4,1234500004,c4@gmail.com,4,Savings ,Customer_Address4,Branch4,BARB0IFSC4,MICR4,Branch_Address4,30-09-2023,11:00:00,30-09-2023,Salary Credit,,,65000.0,250451.0
212,Customer4,1234500004,c4@gmail.com,4,Savings ,Customer_Address4,Branch4,BARB0IFSC4,MICR4,Branch_Address4,30-09-2023,23:59:59,30-09-2023,Quarterly Interest Credit,,,2504.51,252955.51
213,Customer4,1234500004,c4@gmail.com,4,Savings ,Customer_Address4,Branch4,BARB0IFSC4,MICR4,Branch_Address4,04-10-2023,13:45:30,04-10-2023,Mobile Bill Payment-Airtel,,899.0,,252056.51
214,Customer4,1234500004,c4@gmail.com,4,Savings ,Customer_Address4,Branch4,BARB0IFSC4,MICR4,Branch_Address4,07-10-2023,9:45:13,07-10-2023,SIP Investment-ICICI Prudential,,5000.0,,247056.51
215,Customer4,1234500004,c4@gmail.com,4,Savings ,Customer_Address4,Branch4,BARB0IFSC4,MICR4,Branch_Address4,12-10-2023,16:30:22,12-10-2023,POS Transaction-Reliance Digital,,15000.0,,232056.51
216,Customer4,1234500004,c4@gmail.com,4,Savings ,Customer_Address4,Branch4,BARB0IFSC4,MICR4,Branch_Address4,18-10-2023,10:15:40,18-10-2023,NEFT Received from Priya,,,8000.0,240056.51
217,Customer4,1234500004,c4@gmail.com,4,Savings ,Customer_Address4,Branch4,BARB0IFSC4,MICR4,Branch_Address4,24-10-2023,14:50:55,24-10-2023,Car Insurance Premium,,12000.0,,228056.51
218,Customer4,1234500004,c4@gmail.com,4,Savings ,Customer_Address4,Branch4,BARB0IFSC4,MICR4,Branch_Address4,30-10-2023,11:00:00,30-10-2023,Salary Credit,,,65000.0,293056.51
219,Customer4,1234500004,c4@gmail.com,4,Savings ,Customer_Address4,Branch4,BARB0IFSC4,MICR4,Branch_Address4,03-11-2023,15:20:18,03-11-2023,Electricity Bill Payment-BEST,,2100.0,,290956.51
220,Customer4,1234500004,c4@gmail.com,4,Savings ,Customer_Address4,Branch4,BARB0IFSC4,MICR4,Branch_Address4,07-11-2023,9:45:13,07-11-2023,SIP Investment-ICICI Prudential,,5000.0,,285956.51
221,Customer4,1234500004,c4@gmail.com,4,Savings ,Customer_Address4,Branch4,BARB0IFSC4,MICR4,Branch_Address4,13-11-2023,12:35:40,13-11-2023,UPI-BigBasket Groceries,,3500.0,,282456.51
222,Customer4,1234500004,c4@gmail.com,4,Savings ,Customer_Address4,Branch4,BARB0IFSC4,MICR4,Branch_Address4,19-11-2023,17:10:25,19-11-2023,ATM Withdrawal - SBI ATM Andheri,,10000.0,,272456.51
223,Customer4,1234500004,c4@gmail.com,4,Savings ,Customer_Address4,Branch4,BARB0IFSC4,MICR4,Branch_Address4,25-11-2023,11:45:33,25-11-2023,IMPS Transfer to Neha,,5000.0,,267456.51
224,Customer4,1234500004,c4@gmail.com,4,Savings ,Customer_Address4,Branch4,BARB0IFSC4,MICR4,Branch_Address4,30-11-2023,11:00:00,30-11-2023,Salary Credit,,,65000.0,332456.51
225,Customer4,1234500004,c4@gmail.com,4,Savings ,Customer_Address4,Branch4,BARB0IFSC4,MICR4,Branch_Address4,04-12-2023,14:30:22,04-12-2023,Mobile Recharge-Vodafone,,799.0,,331657.51
226,Customer4,1234500004,c4@gmail.com,4,Savings ,Customer_Address4,Branch4,BARB0IFSC4,MICR4,Branch_Address4,07-12-2023,9:45:13,07-12-2023,SIP Investment-ICICI Prudential,,5000.0,,326657.51
227,Customer4,1234500004,c4@gmail.com,4,Savings ,Customer_Address4,Branch4,BARB0IFSC4,MICR4,Branch_Address4,12-12-2023,16:55:40,12-12-2023,POS Transaction-Croma,,8000.0,,318657.51
228,Customer4,1234500004,c4@gmail.com,4,Savings ,Customer_Address4,Branch4,BARB0IFSC4,MICR4,Branch_Address4,18-12-2023,10:20:18,18-12-2023,Cheque Deposit,345678.0,,20000.0,338657.51
229,Customer4,1234500004,c4@gmail.com,4,Savings ,Customer_Address4,Branch4,BARB0IFSC4,MICR4,Branch_Address4,24-12-2023,13:40:55,24-12-2023,UPI-Myntra Shopping,,4500.0,,334157.51
230,Customer4,1234500004,c4@gmail.com,4,Savings ,Customer_Address4,Branch4,BARB0IFSC4,MICR4,Branch_Address4,30-12-2023,11:00:00,30-12-2023,Salary Credit,,,65000.0,399157.51
231,Customer4,1234500004,c4@gmail.com,4,Savings ,Customer_Address4,Branch4,BARB0IFSC4,MICR4,Branch_Address4,31-12-2023,23:59:59,31-12-2023,Quarterly Interest Credit,,,3991.58,403149.09
232,Customer4,1234500004,c4@gmail.com,4,Savings ,Customer_Address4,Branch4,BARB0IFSC4,MICR4,Branch_Address4,03-01-2024,15:15:30,03-01-2024,Electricity Bill Payment-BEST,,2400.0,,400749.09
233,Customer4,1234500004,c4@gmail.com,4,Savings ,Customer_Address4,Branch4,BARB0IFSC4,MICR4,Branch_Address4,07-01-2024,9:45:13,07-01-2024,SIP Investment-ICICI Prudential,,5000.0,,395749.09
234,Customer4,1234500004,c4@gmail.com,4,Savings ,Customer_Address4,Branch4,BARB0IFSC4,MICR4,Branch_Address4,13-01-2024,17:30:22,13-01-2024,Amazon Prime Subscription,,1499.0,,394250.09
235,Customer4,1234500004,c4@gmail.com,4,Savings ,Customer_Address4,Branch4,BARB0IFSC4,MICR4,Branch_Address4,19-01-2024,11:10:40,19-01-2024,NEFT-Income Tax Refund,,,12000.0,406250.09
236,Customer4,1234500004,c4@gmail.com,4,Savings ,Customer_Address4,Branch4,BARB0IFSC4,MICR4,Branch_Address4,25-01-2024,14:45:55,25-01-2024,POS Transaction-Lifestyle,,6000.0,,400250.09
237,Customer4,1234500004,c4@gmail.com,4,Savings ,Customer_Address4,Branch4,BARB0IFSC4,MICR4,Branch_Address4,30-01-2024,11:00:00,30-01-2024,Salary Credit,,,65000.0,465250.09
238,Customer4,1234500004,c4@gmail.com,4,Savings ,Customer_Address4,Branch4,BARB0IFSC4,MICR4,Branch_Address4,04-02-2024,13:20:18,04-02-2024,Mobile Bill Payment-Jio,,799.0,,464451.09
239,Customer4,1234500004,c4@gmail.com,4,Savings ,Customer_Address4,Branch4,BARB0IFSC4,MICR4,Branch_Address4,07-02-2024,9:45:13,07-02-2024,SIP Investment-ICICI Prudential,,5000.0,,459451.09
240,Customer4,1234500004,c4@gmail.com,4,Savings ,Customer_Address4,Branch4,BARB0IFSC4,MICR4,Branch_Address4,12-02-2024,16:35:40,12-02-2024,UPI-Dominos Pizza,,750.0,,458701.09
241,Customer4,1234500004,c4@gmail.com,4,Savings ,Customer_Address4,Branch4,BARB0IFSC4,MICR4,Branch_Address4,18-02-2024,10:50:25,18-02-2024,ATM Withdrawal - ICICI Bank ATM Juhu,,8000.0,,450701.09
242,Customer4,1234500004,c4@gmail.com,4,Savings ,Customer_Address4,Branch4,BARB0IFSC4,MICR4,Branch_Address4,24-02-2024,15:15:33,24-02-2024,IMPS Transfer to Amit,,15000.0,,435701.09
243,Customer4,1234500004,c4@gmail.com,4,Savings ,Customer_Address4,Branch4,BARB0IFSC4,MICR4,Branch_Address4,29-02-2024,11:00:00,29-02-2024,Salary Credit,,,65000.0,500701.09
244,Customer4,1234500004,c4@gmail.com,4,Savings ,Customer_Address4,Branch4,BARB0IFSC4,MICR4,Branch_Address4,04-03-2024,14:40:22,04-03-2024,Electricity Bill Payment-BEST,,2250.0,,498451.09
245,Customer4,1234500004,c4@gmail.com,4,Savings ,Customer_Address4,Branch4,BARB0IFSC4,MICR4,Branch_Address4,07-03-2024,9:45:13,07-03-2024,SIP Investment-ICICI Prudential,,5000.0,,493451.09
246,Customer4,1234500004,c4@gmail.com,4,Savings ,Customer_Address4,Branch4,BARB0IFSC4,MICR4,Branch_Address4,13-03-2024,17:25:40,13-03-2024,POS Transaction-Westside,,4500.0,,488951.09
247,Customer4,1234500004,c4@gmail.com,4,Savings ,Customer_Address4,Branch4,BARB0IFSC4,MICR4,Branch_Address4,19-03-2024,11:30:18,19-03-2024,Cheque Payment,901234.0,30000.0,,458951.09
248,Customer4,1234500004,c4@gmail.com,4,Savings ,Customer_Address4,Branch4,BARB0IFSC4,MICR4,Branch_Address4,25-03-2024,16:50:55,25-03-2024,UPI-Uber Ride,,350.0,,458601.09
249,Customer4,1234500004,c4@gmail.com,4,Savings ,Customer_Address4,Branch4,BARB0IFSC4,MICR4,Branch_Address4,30-03-2024,11:00:00,30-03-2024,Salary Credit,,,65000.0,523601.09
250,Customer4,1234500004,c4@gmail.com,4,Savings ,Customer_Address4,Branch4,BARB0IFSC4,MICR4,Branch_Address4,31-03-2024,23:59:59,31-03-2024,Quarterly Interest Credit,,,5236.01,528837.1
251,Customer4,1234500004,c4@gmail.com,4,Savings ,Customer_Address4,Branch4,BARB0IFSC4,MICR4,Branch_Address4,04-04-2024,15:10:30,04-04-2024,Mobile Recharge-Airtel,,999.0,,527838.1
252,Customer4,1234500004,c4@gmail.com,4,Savings ,Customer_Address4,Branch4,BARB0IFSC4,MICR4,Branch_Address4,07-04-2024,9:45:13,07-04-2024,SIP Investment-ICICI Prudential,,5000.0,,522838.1
253,Customer4,1234500004,c4@gmail.com,4,Savings ,Customer_Address4,Branch4,BARB0IFSC4,MICR4,Branch_Address4,13-04-2024,18:20:22,13-04-2024,UPI-Swiggy Food Order,,950.0,,521888.1
254,Customer4,1234500004,c4@gmail.com,4,Savings ,Customer_Address4,Branch4,BARB0IFSC4,MICR4,Branch_Address4,19-04-2024,10:45:40,19-04-2024,NEFT Received from Sanjay,,,10000.0,531888.1
255,Customer4,1234500004,c4@gmail.com,4,Savings ,Customer_Address4,Branch4,BARB0IFSC4,MICR4,Branch_Address4,25-04-2024,14:15:55,25-04-2024,POS Transaction-12athlon,,3500.0,,528388.1
256,Customer4,1234500004,c4@gmail.com,4,Savings ,Customer_Address4,Branch4,BARB0IFSC4,MICR4,Branch_Address4,30-04-2024,11:00:00,30-04-2024,Salary Credit,,,65000.0,593388.1
257,Customer4,1234500004,c4@gmail.com,4,Savings ,Customer_Address4,Branch4,BARB0IFSC4,MICR4,Branch_Address4,03-05-2024,13:30:18,03-05-2024,Electricity Bill Payment-BEST,,2300.0,,591088.1
258,Customer4,1234500004,c4@gmail.com,4,Savings ,Customer_Address4,Branch4,BARB0IFSC4,MICR4,Branch_Address4,07-05-2024,9:45:13,07-05-2024,SIP Investment-ICICI Prudential,,5000.0,,586088.1
259,Customer4,1234500004,c4@gmail.com,4,Savings ,Customer_Address4,Branch4,BARB0IFSC4,MICR4,Branch_Address4,13-05-2024,16:40:40,13-05-2024,Movie Tickets-PVR Cinemas,,1000.0,,585088.1
260,Customer4,1234500004,c4@gmail.com,4,Savings ,Customer_Address4,Branch4,BARB0IFSC4,MICR4,Branch_Address4,19-05-2024,11:15:25,19-05-2024,ATM Withdrawal - Axis Bank ATM Powai,,7000.0,,578088.1
261,Customer4,1234500004,c4@gmail.com,4,Savings ,Customer_Address4,Branch4,BARB0IFSC4,MICR4,Branch_Address4,25-05-2024,15:50:33,25-05-2024,IMPS Transfer to Sneha,,8000.0,,570088.1
262,Customer4,1234500004,c4@gmail.com,4,Savings ,Customer_Address4,Branch4,BARB0IFSC4,MICR4,Branch_Address4,30-05-2024,11:00:00,30-05-2024,Salary Credit,,,65000.0,635089.1
263,Customer4,1234500004,c4@gmail.com,4,Savings ,Customer_Address4,Branch4,BARB0IFSC4,MICR4,Branch_Address4,04-06-2024,14:25:22,04-06-2024,Mobile Bill Payment-Vodafone,,899.0,,634191.1
264,Customer4,1234500004,c4@gmail.com,4,Savings ,Customer_Address4,Branch4,BARB0IFSC4,MICR4,Branch_Address4,07-06-2024,9:45:13,07-06-2024,SIP Investment-ICICI Prudential,,5000.0,,629192.1
265,Customer4,1234500004,c4@gmail.com,4,Savings ,Customer_Address4,Branch4,BARB0IFSC4,MICR4,Branch_Address4,13-06-2024,17:35:40,13-06-2024,POS Transaction-H&M,,3500.0,,625693.1
266,Customer4,1234500004,c4@gmail.com,4,Savings ,Customer_Address4,Branch4,BARB0IFSC4,MICR4,Branch_Address4,19-06-2024,10:50:18,19-06-2024,Cheque Deposit,567890.0,,25000.0,650694.1
267,Customer4,1234500004,c4@gmail.com,4,Savings ,Customer_Address4,Branch4,BARB0IFSC4,MICR4,Branch_Address4,25-06-2024,16:20:55,25-06-2024,UPI-BigBasket Groceries,,4000.0,,646695.1
268,Customer4,1234500004,c4@gmail.com,4,Savings ,Customer_Address4,Branch4,BARB0IFSC4,MICR4,Branch_Address4,30-06-2024,11:00:00,30-06-2024,Salary Credit,,,65000.0,711696.1
269,Customer4,1234500004,c4@gmail.com,4,Savings ,Customer_Address4,Branch4,BARB0IFSC4,MICR4,Branch_Address4,30-06-2024,23:59:59,30-06-2024,Quarterly Interest Credit,,,7116.89,718813.99
270,Customer4,1234500004,c4@gmail.com,4,Savings ,Customer_Address4,Branch4,BARB0IFSC4,MICR4,Branch_Address4,04-07-2024,15:40:30,04-07-2024,Electricity Bill Payment-BEST,,2500.0,,716314.99
271,Customer4,1234500004,c4@gmail.com,4,Savings ,Customer_Address4,Branch4,BARB0IFSC4,MICR4,Branch_Address4,07-07-2024,9:45:13,07-07-2024,SIP Investment-ICICI Prudential,,5000.0,,711315.99
272,Customer4,1234500004,c4@gmail.com,4,Savings ,Customer_Address4,Branch4,BARB0IFSC4,MICR4,Branch_Address4,13-07-2024,18:15:22,13-07-2024,Amazon Shopping,,5500.0,,705816.99
273,Customer4,1234500004,c4@gmail.com,4,Savings ,Customer_Address4,Branch4,BARB0IFSC4,MICR4,Branch_Address4,19-07-2024,11:30:40,19-07-2024,NEFT-Freelance Payment,,,20000.0,725817.99
274,Customer4,1234500004,c4@gmail.com,4,Savings ,Customer_Address4,Branch4,BARB0IFSC4,MICR4,Branch_Address4,25-07-2024,14:55:55,25-07-2024,POS Transaction-Tanishq,,50000.0,,775818.99
275,Customer4,1234500004,c4@gmail.com,4,Savings ,Customer_Address4,Branch4,BARB0IFSC4,MICR4,Branch_Address4,30-07-2024,11:00:00,30-07-2024,Salary Credit,,,65000.0,840819.99
276,Customer4,1234500004,c4@gmail.com,4,Savings ,Customer_Address4,Branch4,BARB0IFSC4,MICR4,Branch_Address4,31-07-2024,11:17:25,31-07-2024,ATM Withdrawal - Axis Bank ATM Powai,,7000.0,,833819.99
277,Customer4,1234500004,c4@gmail.com,4,Savings ,Customer_Address4,Branch4,BARB0IFSC4,MICR4,Branch_Address4,31-07-2024,11:18:20,31-07-2024,ATM Withdrawal - Axis Bank ATM Shimla,,15000.0,,818819.99
278,Customer5,1234500005,c5@gmail.com,5,Savings ,Customer_Address5,Branch5,BARB0IFSC5,MICR5,Branch_Address5,01-01-2024,9:15:00,01-01-2024,ATM Withdrawal - HDFC Bank ATM Bandra,,15000.0,,185000.0
279,Customer5,1234500005,c5@gmail.com,5,Savings ,Customer_Address5,Branch5,BARB0IFSC5,MICR5,Branch_Address5,05-01-2024,14:30:00,05-01-2024,NEFT Transfer to Akash Sharma,,25000.0,,160000.0
280,Customer5,1234500005,c5@gmail.com,5,Savings ,Customer_Address5,Branch5,BARB0IFSC5,MICR5,Branch_Address5,10-01-2024,11:45:00,10-01-2024,Electricity Bill Payment - BEST,,3500.0,,156500.0
281,Customer5,1234500005,c5@gmail.com,5,Savings ,Customer_Address5,Branch5,BARB0IFSC5,MICR5,Branch_Address5,15-01-2024,10:00:00,15-01-2024,Salary Credit,,,75000.0,231500.0
282,Customer5,1234500005,c5@gmail.com,5,Savings ,Customer_Address5,Branch5,BARB0IFSC5,MICR5,Branch_Address5,18-01-2024,16:20:00,18-01-2024,Amazon.in Purchase,,8900.0,,222600.0
283,Customer5,1234500005,c5@gmail.com,5,Savings ,Customer_Address5,Branch5,BARB0IFSC5,MICR5,Branch_Address5,22-01-2024,13:10:00,22-01-2024,SIP Investment - ICICI Prudential,,10000.0,,212600.0
284,Customer5,1234500005,c5@gmail.com,5,Savings ,Customer_Address5,Branch5,BARB0IFSC5,MICR5,Branch_Address5,28-01-2024,19:45:00,28-01-2024,Swiggy Food Order,,1200.0,,211400.0
285,Customer5,1234500005,c5@gmail.com,5,Savings ,Customer_Address5,Branch5,BARB0IFSC5,MICR5,Branch_Address5,02-02-2024,11:30:00,02-02-2024,Mobile Recharge - Jio,,999.0,,210401.0
286,Customer5,1234500005,c5@gmail.com,5,Savings ,Customer_Address5,Branch5,BARB0IFSC5,MICR5,Branch_Address5,07-02-2024,14:15:00,07-02-2024,Cheque Deposit,123456.0,,35000.0,245401.0
287,Customer5,1234500005,c5@gmail.com,5,Savings ,Customer_Address5,Branch5,BARB0IFSC5,MICR5,Branch_Address5,12-02-2024,10:30:00,12-02-2024,Gas Bill Payment,,850.0,,244551.0
288,Customer5,1234500005,c5@gmail.com,5,Savings ,Customer_Address5,Branch5,BARB0IFSC5,MICR5,Branch_Address5,15-02-2024,10:00:00,15-02-2024,Salary Credit,,,75000.0,319551.0
289,Customer5,1234500005,c5@gmail.com,5,Savings ,Customer_Address5,Branch5,BARB0IFSC5,MICR5,Branch_Address5,19-02-2024,17:00:00,19-02-2024,IRCTC Train Ticket Booking,,3500.0,,316051.0
290,Customer5,1234500005,c5@gmail.com,5,Savings ,Customer_Address5,Branch5,BARB0IFSC5,MICR5,Branch_Address5,22-02-2024,13:10:00,22-02-2024,SIP Investment - ICICI Prudential,,10000.0,,306051.0
291,Customer5,1234500005,c5@gmail.com,5,Savings ,Customer_Address5,Branch5,BARB0IFSC5,MICR5,Branch_Address5,26-02-2024,12:45:00,26-02-2024,Flipkart Electronics Purchase,,22000.0,,284051.0
292,Customer5,1234500005,c5@gmail.com,5,Savings ,Customer_Address5,Branch5,BARB0IFSC5,MICR5,Branch_Address5,03-03-2024,9:30:00,03-03-2024,ATM Withdrawal - SBI ATM Andheri,,20000.0,,264051.0
293,Customer5,1234500005,c5@gmail.com,5,Savings ,Customer_Address5,Branch5,BARB0IFSC5,MICR5,Branch_Address5,08-03-2024,15:20:00,08-03-2024,Health Insurance Premium,,12000.0,,252051.0
294,Customer5,1234500005,c5@gmail.com,5,Savings ,Customer_Address5,Branch5,BARB0IFSC5,MICR5,Branch_Address5,13-03-2024,11:00:00,13-03-2024,Electricity Bill Payment - BEST,,3800.0,,248251.0
295,Customer5,1234500005,c5@gmail.com,5,Savings ,Customer_Address5,Branch5,BARB0IFSC5,MICR5,Branch_Address5,15-03-2024,10:00:00,15-03-2024,Salary Credit,,,75000.0,323251.0
296,Customer5,1234500005,c5@gmail.com,5,Savings ,Customer_Address5,Branch5,BARB0IFSC5,MICR5,Branch_Address5,20-03-2024,14:30:00,20-03-2024,UPI Payment to Local Grocery Store,,5500.0,,317751.0
297,Customer5,1234500005,c5@gmail.com,5,Savings ,Customer_Address5,Branch5,BARB0IFSC5,MICR5,Branch_Address5,22-03-2024,13:10:00,22-03-2024,SIP Investment - ICICI Prudential,,10000.0,,307751.0
298,Customer5,1234500005,c5@gmail.com,5,Savings ,Customer_Address5,Branch5,BARB0IFSC5,MICR5,Branch_Address5,27-03-2024,16:45:00,27-03-2024,Myntra Clothing Purchase,,7800.0,,299951.0
299,Customer5,1234500005,c5@gmail.com,5,Savings ,Customer_Address5,Branch5,BARB0IFSC5,MICR5,Branch_Address5,31-03-2024,23:59:00,31-03-2024,Quarterly Interest Credit,,,3000.0,302951.0
300,Customer5,1234500005,c5@gmail.com,5,Savings ,Customer_Address5,Branch5,BARB0IFSC5,MICR5,Branch_Address5,04-04-2024,10:15:00,04-04-2024,Mobile Bill Payment - Airtel,,1299.0,,301652.0
301,Customer5,1234500005,c5@gmail.com,5,Savings ,Customer_Address5,Branch5,BARB0IFSC5,MICR5,Branch_Address5,09-04-2024,12:30:00,09-04-2024,Cheque Payment,789012.0,18000.0,,283652.0
302,Customer5,1234500005,c5@gmail.com,5,Savings ,Customer_Address5,Branch5,BARB0IFSC5,MICR5,Branch_Address5,14-04-2024,18:00:00,14-04-2024,Zomato Food Delivery,,1500.0,,282152.0
303,Customer5,1234500005,c5@gmail.com,5,Savings ,Customer_Address5,Branch5,BARB0IFSC5,MICR5,Branch_Address5,15-04-2024,10:00:00,15-04-2024,Salary Credit,,,75000.0,357152.0
304,Customer5,1234500005,c5@gmail.com,5,Savings ,Customer_Address5,Branch5,BARB0IFSC5,MICR5,Branch_Address5,19-04-2024,11:45:00,19-04-2024,DTH Recharge - Tata Sky,,6000.0,,351152.0
305,Customer5,1234500005,c5@gmail.com,5,Savings ,Customer_Address5,Branch5,BARB0IFSC5,MICR5,Branch_Address5,22-04-2024,13:10:00,22-04-2024,SIP Investment - ICICI Prudential,,10000.0,,341152.0
306,Customer5,1234500005,c5@gmail.com,5,Savings ,Customer_Address5,Branch5,BARB0IFSC5,MICR5,Branch_Address5,26-04-2024,15:30:00,26-04-2024,NEFT Transfer to Priya Patel,,30000.0,,311152.0
307,Customer5,1234500005,c5@gmail.com,5,Savings ,Customer_Address5,Branch5,BARB0IFSC5,MICR5,Branch_Address5,02-05-2024,9:45:00,02-05-2024,ATM Withdrawal - ICICI Bank ATM Juhu,,20000.0,,291152.0
308,Customer5,1234500005,c5@gmail.com,5,Savings ,Customer_Address5,Branch5,BARB0IFSC5,MICR5,Branch_Address5,07-05-2024,14:00:00,07-05-2024,Electricity Bill Payment - BEST,,9100.0,,282052.0
309,Customer5,1234500005,c5@gmail.com,5,Savings ,Customer_Address5,Branch5,BARB0IFSC5,MICR5,Branch_Address5,12-05-2024,16:30:00,12-05-2024,Amazon Prime Subscription Renewal,,1499.0,,280553.0
310,Customer5,1234500005,c5@gmail.com,5,Savings ,Customer_Address5,Branch5,BARB0IFSC5,MICR5,Branch_Address5,15-05-2024,10:00:00,15-05-2024,Salary Credit,,,75000.0,355553.0
311,Customer5,1234500005,c5@gmail.com,5,Savings ,Customer_Address5,Branch5,BARB0IFSC5,MICR5,Branch_Address5,19-05-2024,11:20:00,19-05-2024,UPI Payment to Local Vegetable Vendor,,2000.0,,353553.0
312,Customer5,1234500005,c5@gmail.com,5,Savings ,Customer_Address5,Branch5,BARB0IFSC5,MICR5,Branch_Address5,22-05-2024,13:10:00,22-05-2024,SIP Investment - ICICI Prudential,,10000.0,,343553.0
313,Customer5,1234500005,c5@gmail.com,5,Savings ,Customer_Address5,Branch5,BARB0IFSC5,MICR5,Branch_Address5,27-05-2024,17:45:00,27-05-2024,IRCTC Flight Ticket Booking,,15000.0,,328553.0
314,Customer5,1234500005,c5@gmail.com,5,Savings ,Customer_Address5,Branch5,BARB0IFSC5,MICR5,Branch_Address5,01-06-2024,10:30:00,01-06-2024,Gas Bill Payment,,950.0,,327603.0
315,Customer5,1234500005,c5@gmail.com,5,Savings ,Customer_Address5,Branch5,BARB0IFSC5,MICR5,Branch_Address5,06-06-2024,12:15:00,06-06-2024,Cheque Deposit,345678.0,,40000.0,367603.0
316,Customer5,1234500005,c5@gmail.com,5,Savings ,Customer_Address5,Branch5,BARB0IFSC5,MICR5,Branch_Address5,11-06-2024,15:00:00,11-06-2024,Mobile Recharge - Vodafone,,799.0,,366804.0
317,Customer5,1234500005,c5@gmail.com,5,Savings ,Customer_Address5,Branch5,BARB0IFSC5,MICR5,Branch_Address5,15-06-2024,10:00:00,15-06-2024,Salary Credit,,,75000.0,441804.0
318,Customer5,1234500005,c5@gmail.com,5,Savings ,Customer_Address5,Branch5,BARB0IFSC5,MICR5,Branch_Address5,19-06-2024,14:45:00,19-06-2024,Flipkart Fashion Purchase,,6500.0,,435304.0
319,Customer5,1234500005,c5@gmail.com,5,Savings ,Customer_Address5,Branch5,BARB0IFSC5,MICR5,Branch_Address5,22-06-2024,13:10:00,22-06-2024,SIP Investment - ICICI Prudential,,10000.0,,425304.0
320,Customer5,1234500005,c5@gmail.com,5,Savings ,Customer_Address5,Branch5,BARB0IFSC5,MICR5,Branch_Address5,26-06-2024,16:30:00,26-06-2024,Netflix Subscription Renewal,,649.0,,424655.0
321,Customer5,1234500005,c5@gmail.com,5,Savings ,Customer_Address5,Branch5,BARB0IFSC5,MICR5,Branch_Address5,30-06-2024,23:59:00,30-06-2024,Quarterly Interest Credit,,,4250.0,428905.0
322,Customer5,1234500005,c5@gmail.com,5,Savings ,Customer_Address5,Branch5,BARB0IFSC5,MICR5,Branch_Address5,04-07-2024,11:00:00,04-07-2024,Electricity Bill Payment - BEST,,4300.0,,424605.0
323,Customer5,1234500005,c5@gmail.com,5,Savings ,Customer_Address5,Branch5,BARB0IFSC5,MICR5,Branch_Address5,09-07-2024,13:30:00,09-07-2024,UPI Payment to Local Pharmacy,,3500.0,,421105.0
324,Customer5,1234500005,c5@gmail.com,5,Savings ,Customer_Address5,Branch5,BARB0IFSC5,MICR5,Branch_Address5,14-07-2024,17:15:00,14-07-2024,Swiggy Food Order,,1800.0,,419305.0
325,Customer5,1234500005,c5@gmail.com,5,Savings ,Customer_Address5,Branch5,BARB0IFSC5,MICR5,Branch_Address5,15-07-2024,10:00:00,15-07-2024,Salary Credit,,,75000.0,494305.0
326,Customer5,1234500005,c5@gmail.com,5,Savings ,Customer_Address5,Branch5,BARB0IFSC5,MICR5,Branch_Address5,19-07-2024,12:45:00,19-07-2024,DTH Recharge - Dish TV,,5500.0,,488805.0
327,Customer5,1234500005,c5@gmail.com,5,Savings ,Customer_Address5,Branch5,BARB0IFSC5,MICR5,Branch_Address5,22-07-2024,13:10:00,22-07-2024,SIP Investment - ICICI Prudential,,10000.0,,478805.0
328,Customer5,1234500005,c5@gmail.com,5,Savings ,Customer_Address5,Branch5,BARB0IFSC5,MICR5,Branch_Address5,31-07-2024,15:30:00,31-07-2024,Cash Deposit,,,1100000.0,1578805.0
329,Customer5,1234500005,c5@gmail.com,5,Savings ,Customer_Address5,Branch5,BARB0IFSC5,MICR5,Branch_Address5,31-07-2024,18:00:00,31-07-2024,Amazon.in Electronics Purchase,,35000.0,,1543805.0
330,Customer6,1234500006,c6@gmail.com,6,Savings ,Customer_Address6,Branch6,BARB0IFSC6,MICR6,Branch_Address6,15-09-2023,9:00:00,15-09-2023,Cash Deposit,,,50000.0,50000.0
331,Customer6,1234500006,c6@gmail.com,6,Savings ,Customer_Address6,Branch6,BARB0IFSC6,MICR6,Branch_Address6,18-09-2023,14:30:15,18-09-2023,Medicine,,1200.0,,48800.0
332,Customer6,1234500006,c6@gmail.com,6,Savings ,Customer_Address6,Branch6,BARB0IFSC6,MICR6,Branch_Address6,22-09-2023,11:45:30,22-09-2023,Shopping from local 03ket,,3500.0,,45300.0
333,Customer6,1234500006,c6@gmail.com,6,Savings ,Customer_Address6,Branch6,BARB0IFSC6,MICR6,Branch_Address6,28-09-2023,16:20:45,28-09-2023,Electricity Bill Payment,,1800.0,,43500.0
334,Customer6,1234500006,c6@gmail.com,6,Savings ,Customer_Address6,Branch6,BARB0IFSC6,MICR6,Branch_Address6,30-09-2023,9:15:00,30-09-2023,Salary Credit,,,65000.0,108500.0
335,Customer6,1234500006,c6@gmail.com,6,Savings ,Customer_Address6,Branch6,BARB0IFSC6,MICR6,Branch_Address6,05-10-2023,10:30:20,05-10-2023,Grocery Shopping,,4200.0,,104300.0
336,Customer6,1234500006,c6@gmail.com,6,Savings ,Customer_Address6,Branch6,BARB0IFSC6,MICR6,Branch_Address6,12-10-2023,13:45:30,12-10-2023,Mobile Recharge,,999.0,,103301.0
337,Customer6,1234500006,c6@gmail.com,6,Savings ,Customer_Address6,Branch6,BARB0IFSC6,MICR6,Branch_Address6,16-10-2023,9:00:00,16-10-2023,SIP Investment,,5000.0,,98301.0
338,Customer6,1234500006,c6@gmail.com,6,Savings ,Customer_Address6,Branch6,BARB0IFSC6,MICR6,Branch_Address6,20-10-2023,20:15:45,20-10-2023,Restaurant Bill,,2500.0,,95801.0
339,Customer6,1234500006,c6@gmail.com,6,Savings ,Customer_Address6,Branch6,BARB0IFSC6,MICR6,Branch_Address6,26-10-2023,11:30:00,26-10-2023,Gas Bill Payment,,950.0,,94851.0
340,Customer6,1234500006,c6@gmail.com,6,Savings ,Customer_Address6,Branch6,BARB0IFSC6,MICR6,Branch_Address6,31-10-2023,9:15:00,31-10-2023,Salary Credit,,,65000.0,159851.0
341,Customer6,1234500006,c6@gmail.com,6,Savings ,Customer_Address6,Branch6,BARB0IFSC6,MICR6,Branch_Address6,03-11-2023,14:20:30,03-11-2023,Health Insurance Premium,,12000.0,,147851.0
342,Customer6,1234500006,c6@gmail.com,6,Savings ,Customer_Address6,Branch6,BARB0IFSC6,MICR6,Branch_Address6,08-11-2023,16:45:00,08-11-2023,Online Course Payment,,8500.0,,139351.0
343,Customer6,1234500006,c6@gmail.com,6,Savings ,Customer_Address6,Branch6,BARB0IFSC6,MICR6,Branch_Address6,13-11-2023,19:30:15,13-11-2023,Movie Tickets,,600.0,,138751.0
344,Customer6,1234500006,c6@gmail.com,6,Savings ,Customer_Address6,Branch6,BARB0IFSC6,MICR6,Branch_Address6,16-11-2023,9:00:00,16-11-2023,SIP Investment,,5000.0,,133751.0
345,Customer6,1234500006,c6@gmail.com,6,Savings ,Customer_Address6,Branch6,BARB0IFSC6,MICR6,Branch_Address6,21-11-2023,12:15:30,21-11-2023,Clothing Purchase,,3500.0,,130251.0
346,Customer6,1234500006,c6@gmail.com,6,Savings ,Customer_Address6,Branch6,BARB0IFSC6,MICR6,Branch_Address6,27-11-2023,10:45:00,27-11-2023,Internet Bill Payment,,1200.0,,129051.0
347,Customer6,1234500006,c6@gmail.com,6,Savings ,Customer_Address6,Branch6,BARB0IFSC6,MICR6,Branch_Address6,30-11-2023,9:15:00,30-11-2023,Salary Credit,,,65000.0,194051.0
348,Customer6,1234500006,c6@gmail.com,6,Savings ,Customer_Address6,Branch6,BARB0IFSC6,MICR6,Branch_Address6,04-12-2023,11:30:45,04-12-2023,Car Service,,5000.0,,189051.0
349,Customer6,1234500006,c6@gmail.com,6,Savings ,Customer_Address6,Branch6,BARB0IFSC6,MICR6,Branch_Address6,09-12-2023,15:20:00,09-12-2023,Gift Purchase,,2000.0,,187051.0
350,Customer6,1234500006,c6@gmail.com,6,Savings ,Customer_Address6,Branch6,BARB0IFSC6,MICR6,Branch_Address6,14-12-2023,17:45:30,14-12-2023,Electricity Bill Payment,,1900.0,,185151.0
351,Customer6,1234500006,c6@gmail.com,6,Savings ,Customer_Address6,Branch6,BARB0IFSC6,MICR6,Branch_Address6,16-12-2023,9:00:00,16-12-2023,SIP Investment,,5000.0,,180151.0
352,Customer6,1234500006,c6@gmail.com,6,Savings ,Customer_Address6,Branch6,BARB0IFSC6,MICR6,Branch_Address6,20-12-2023,13:10:15,20-12-2023,Gym Membership Renewal,,12000.0,,168151.0
353,Customer6,1234500006,c6@gmail.com,6,Savings ,Customer_Address6,Branch6,BARB0IFSC6,MICR6,Branch_Address6,26-12-2023,18:30:00,26-12-2023,Mobile Phone Purchase,,25000.0,,143151.0
354,Customer6,1234500006,c6@gmail.com,6,Savings ,Customer_Address6,Branch6,BARB0IFSC6,MICR6,Branch_Address6,30-12-2023,9:15:00,30-12-2023,Salary Credit,,,65000.0,208151.0
355,Customer6,1234500006,c6@gmail.com,6,Savings ,Customer_Address6,Branch6,BARB0IFSC6,MICR6,Branch_Address6,31-12-2023,23:59:59,31-12-2023,Quarterly Interest Credit,,,2081.51,210232.51
356,Customer6,1234500006,c6@gmail.com,6,Savings ,Customer_Address6,Branch6,BARB0IFSC6,MICR6,Branch_Address6,02-01-2024,22:15:30,02-01-2024,New Year Party Expenses,,8000.0,,202232.51
357,Customer6,1234500006,c6@gmail.com,6,Savings ,Customer_Address6,Branch6,BARB0IFSC6,MICR6,Branch_Address6,07-01-2024,10:30:00,07-01-2024,Flight Tickets,,15000.0,,187232.51
358,Customer6,1234500006,c6@gmail.com,6,Savings ,Customer_Address6,Branch6,BARB0IFSC6,MICR6,Branch_Address6,16-01-2024,9:00:00,16-01-2024,SIP Investment,,5000.0,,182232.51
359,Customer6,1234500006,c6@gmail.com,6,Savings ,Customer_Address6,Branch6,BARB0IFSC6,MICR6,Branch_Address6,21-01-2024,14:45:15,21-01-2024,Hotel Booking,,12000.0,,170232.51
360,Customer6,1234500006,c6@gmail.com,6,Savings ,Customer_Address6,Branch6,BARB0IFSC6,MICR6,Branch_Address6,26-01-2024,11:20:30,26-01-2024,Gas Bill Payment,,980.0,,169252.51
361,Customer6,1234500006,c6@gmail.com,6,Savings ,Customer_Address6,Branch6,BARB0IFSC6,MICR6,Branch_Address6,31-01-2024,9:15:00,31-01-2024,Salary Credit,,,65000.0,234252.51
362,Customer6,1234500006,c6@gmail.com,6,Savings ,Customer_Address6,Branch6,BARB0IFSC6,MICR6,Branch_Address6,05-02-2024,16:30:45,05-02-2024,Grocery Shopping,,4500.0,,229752.51
363,Customer6,1234500006,c6@gmail.com,6,Savings ,Customer_Address6,Branch6,BARB0IFSC6,MICR6,Branch_Address6,10-02-2024,12:15:00,10-02-2024,Home Appliance Purchase,,20000.0,,209752.51
364,Customer6,1234500006,c6@gmail.com,6,Savings ,Customer_Address6,Branch6,BARB0IFSC6,MICR6,Branch_Address6,14-02-2024,9:45:30,14-02-2024,Mobile Recharge,,999.0,,208753.51
365,Customer6,1234500006,c6@gmail.com,6,Savings ,Customer_Address6,Branch6,BARB0IFSC6,MICR6,Branch_Address6,16-02-2024,9:00:00,16-02-2024,SIP Investment,,5000.0,,203753.51
366,Customer6,1234500006,c6@gmail.com,6,Savings ,Customer_Address6,Branch6,BARB0IFSC6,MICR6,Branch_Address6,22-02-2024,19:30:15,22-02-2024,Restaurant Bill,,3000.0,,200753.51
367,Customer6,1234500006,c6@gmail.com,6,Savings ,Customer_Address6,Branch6,BARB0IFSC6,MICR6,Branch_Address6,27-02-2024,11:45:00,27-02-2024,Electricity Bill Payment,,1850.0,,198903.51
368,Customer6,1234500006,c6@gmail.com,6,Savings ,Customer_Address6,Branch6,BARB0IFSC6,MICR6,Branch_Address6,29-02-2024,9:15:00,29-02-2024,Salary Credit,,,65000.0,263903.51
369,Customer6,1234500006,c6@gmail.com,6,Savings ,Customer_Address6,Branch6,BARB0IFSC6,MICR6,Branch_Address6,04-03-2024,14:20:30,04-03-2024,Car Insurance Premium,,15000.0,,248903.51
370,Customer6,1234500006,c6@gmail.com,6,Savings ,Customer_Address6,Branch6,BARB0IFSC6,MICR6,Branch_Address6,09-03-2024,10:30:00,09-03-2024,Online Shopping - Flipkart,,7500.0,,241403.51
371,Customer6,1234500006,c6@gmail.com,6,Savings ,Customer_Address6,Branch6,BARB0IFSC6,MICR6,Branch_Address6,13-03-2024,18:45:15,13-03-2024,Movie Tickets,,750.0,,240653.51
372,Customer6,1234500006,c6@gmail.com,6,Savings ,Customer_Address6,Branch6,BARB0IFSC6,MICR6,Branch_Address6,16-03-2024,9:00:00,16-03-2024,SIP Investment,,5000.0,,235653.51
373,Customer6,1234500006,c6@gmail.com,6,Savings ,Customer_Address6,Branch6,BARB0IFSC6,MICR6,Branch_Address6,21-03-2024,12:15:30,21-03-2024,Clothing Purchase,,4000.0,,231653.51
374,Customer6,1234500006,c6@gmail.com,6,Savings ,Customer_Address6,Branch6,BARB0IFSC6,MICR6,Branch_Address6,26-03-2024,15:30:45,26-03-2024,Internet Bill Payment,,1200.0,,230453.51
375,Customer6,1234500006,c6@gmail.com,6,Savings ,Customer_Address6,Branch6,BARB0IFSC6,MICR6,Branch_Address6,31-03-2024,9:15:00,31-03-2024,Salary Credit,,,65000.0,295453.51
376,Customer6,1234500006,c6@gmail.com,6,Savings ,Customer_Address6,Branch6,BARB0IFSC6,MICR6,Branch_Address6,31-03-2024,23:59:59,31-03-2024,Quarterly Interest Credit,,,2954.54,298408.05
377,Customer6,1234500006,c6@gmail.com,6,Savings ,Customer_Address6,Branch6,BARB0IFSC6,MICR6,Branch_Address6,05-04-2024,11:30:00,05-04-2024,Home Re11ation Expenses,,50000.0,,248408.05
378,Customer6,1234500006,c6@gmail.com,6,Savings ,Customer_Address6,Branch6,BARB0IFSC6,MICR6,Branch_Address6,10-04-2024,14:45:30,10-04-2024,Grocery Shopping,,5000.0,,243408.05
379,Customer6,1234500006,c6@gmail.com,6,Savings ,Customer_Address6,Branch6,BARB0IFSC6,MICR6,Branch_Address6,16-04-2024,9:00:00,16-04-2024,SIP Investment,,5000.0,,238408.05
380,Customer6,1234500006,c6@gmail.com,6,Savings ,Customer_Address6,Branch6,BARB0IFSC6,MICR6,Branch_Address6,20-04-2024,16:20:15,20-04-2024,Electronics Purchase,,30000.0,,208408.05
381,Customer6,1234500006,c6@gmail.com,6,Savings ,Customer_Address6,Branch6,BARB0IFSC6,MICR6,Branch_Address6,25-04-2024,10:30:45,25-04-2024,Gas Bill Payment,,1000.0,,207408.05
382,Customer6,1234500006,c6@gmail.com,6,Savings ,Customer_Address6,Branch6,BARB0IFSC6,MICR6,Branch_Address6,30-04-2024,9:15:00,30-04-2024,Salary Credit,,,65000.0,272408.05
383,Customer6,1234500006,c6@gmail.com,6,Savings ,Customer_Address6,Branch6,BARB0IFSC6,MICR6,Branch_Address6,04-05-2024,13:45:30,04-05-2024,Health Check-up,,5000.0,,267408.05
384,Customer6,1234500006,c6@gmail.com,6,Savings ,Customer_Address6,Branch6,BARB0IFSC6,MICR6,Branch_Address6,09-05-2024,17:30:00,09-05-2024,Gift Purchase,,3000.0,,264408.05
385,Customer6,1234500006,c6@gmail.com,6,Savings ,Customer_Address6,Branch6,BARB0IFSC6,MICR6,Branch_Address6,13-05-2024,11:15:45,13-05-2024,Mobile Recharge,,999.0,,263409.05
386,Customer6,1234500006,c6@gmail.com,6,Savings ,Customer_Address6,Branch6,BARB0IFSC6,MICR6,Branch_Address6,16-05-2024,9:00:00,16-05-2024,SIP Investment,,5000.0,,258409.05
387,Customer6,1234500006,c6@gmail.com,6,Savings ,Customer_Address6,Branch6,BARB0IFSC6,MICR6,Branch_Address6,21-05-2024,19:45:30,21-05-2024,Restaurant Bill,,3500.0,,254909.05
388,Customer6,1234500006,c6@gmail.com,6,Savings ,Customer_Address6,Branch6,BARB0IFSC6,MICR6,Branch_Address6,26-05-2024,12:30:15,26-05-2024,Electricity Bill Payment,,2000.0,,252909.05
389,Customer6,1234500006,c6@gmail.com,6,Savings ,Customer_Address6,Branch6,BARB0IFSC6,MICR6,Branch_Address6,31-05-2024,9:15:00,31-05-2024,Salary Credit,,,65000.0,317909.05
390,Customer6,1234500006,c6@gmail.com,6,Savings ,Customer_Address6,Branch6,BARB0IFSC6,MICR6,Branch_Address6,03-06-2024,10:30:45,03-06-2024,Vacation Expenses,,40000.0,,277909.05
391,Customer6,1234500006,c6@gmail.com,6,Savings ,Customer_Address6,Branch6,BARB0IFSC6,MICR6,Branch_Address6,08-06-2024,14:15:00,08-06-2024,Grocery Shopping,,4800.0,,273109.05
392,Customer6,1234500006,c6@gmail.com,6,Savings ,Customer_Address6,Branch6,BARB0IFSC6,MICR6,Branch_Address6,12-06-2024,16:45:30,12-06-2024,Online Course Payment,,10000.0,,263109.05
393,Customer6,1234500006,c6@gmail.com,6,Savings ,Customer_Address6,Branch6,BARB0IFSC6,MICR6,Branch_Address6,16-06-2024,9:00:00,16-06-2024,SIP Investment,,5000.0,,258109.05
394,Customer6,1234500006,c6@gmail.com,6,Savings ,Customer_Address6,Branch6,BARB0IFSC6,MICR6,Branch_Address6,21-06-2024,11:30:15,21-06-2024,Furniture Purchase,,25000.0,,233109.05
395,Customer6,1234500006,c6@gmail.com,6,Savings ,Customer_Address6,Branch6,BARB0IFSC6,MICR6,Branch_Address6,26-06-2024,15:20:45,26-06-2024,Internet Bill Payment,,1200.0,,231909.05
396,Customer6,1234500006,c6@gmail.com,6,Savings ,Customer_Address6,Branch6,BARB0IFSC6,MICR6,Branch_Address6,30-06-2024,9:15:00,30-06-2024,Salary Credit,,,65000.0,296909.05
397,Customer6,1234500006,c6@gmail.com,6,Savings ,Customer_Address6,Branch6,BARB0IFSC6,MICR6,Branch_Address6,30-06-2024,23:59:59,30-06-2024,Quarterly Interest Credit,,,2969.09,299878.14
398,Customer6,1234500006,c6@gmail.com,6,Savings ,Customer_Address6,Branch6,BARB0IFSC6,MICR6,Branch_Address6,04-07-2024,12:45:30,04-07-2024,Car Service,,6000.0,,293878.14
399,Customer6,1234500006,c6@gmail.com,6,Savings ,Customer_Address6,Branch6,BARB0IFSC6,MICR6,Branch_Address6,09-07-2024,17:30:00,09-07-2024,Mobile Phone Purchase,,30000.0,,263878.14
400,Customer6,1234500006,c6@gmail.com,6,Savings ,Customer_Address6,Branch6,BARB0IFSC6,MICR6,Branch_Address6,16-07-2024,9:00:00,16-07-2024,SIP Investment,,5000.0,,258878.14
401,Customer6,1234500006,c6@gmail.com,6,Savings ,Customer_Address6,Branch6,BARB0IFSC6,MICR6,Branch_Address6,20-07-2024,20:15:45,20-07-2024,Restaurant Bill,,4000.0,,254878.14
402,Customer6,1234500006,c6@gmail.com,6,Savings ,Customer_Address6,Branch6,BARB0IFSC6,MICR6,Branch_Address6,25-07-2024,11:30:00,25-07-2024,Gas Bill Payment,,1050.0,,253828.14
403,Customer6,1234500006,c6@gmail.com,6,Savings ,Customer_Address6,Branch6,BARB0IFSC6,MICR6,Branch_Address6,31-07-2024,9:15:00,31-07-2024,Salary Credit,,,65000.0,318828.14
404,Customer7,1234500007,c7@gmail.com,7,Savings ,Customer_Address7,Branch7,BARB0IFSC7,MICR7,Branch_Address7,03-11-2023,14:30:00,03-11-2023,ATM Withdrawal - Malad West,,5000.0,,120000.0
405,Customer7,1234500007,c7@gmail.com,7,Savings ,Customer_Address7,Branch7,BARB0IFSC7,MICR7,Branch_Address7,07-11-2023,11:45:00,07-11-2023,NEFT-ICICI-xxxxxxxxxx1234-Home Rent,,22000.0,,98000.0
406,Customer7,1234500007,c7@gmail.com,7,Savings ,Customer_Address7,Branch7,BARB0IFSC7,MICR7,Branch_Address7,12-11-2023,16:20:00,12-11-2023,UPI-ZOMATO-ORDER12345,,750.0,,97250.0
407,Customer7,1234500007,c7@gmail.com,7,Savings ,Customer_Address7,Branch7,BARB0IFSC7,MICR7,Branch_Address7,18-11-2023,10:00:00,18-11-2023,Cheque Deposit,123456.0,,35000.0,132250.0
408,Customer7,1234500007,c7@gmail.com,7,Savings ,Customer_Address7,Branch7,BARB0IFSC7,MICR7,Branch_Address7,22-11-2023,9:30:00,22-11-2023,IMPS-HDFC-xxxxxxxxxx5678-Car EMI,,12500.0,,119750.0
409,Customer7,1234500007,c7@gmail.com,7,Savings ,Customer_Address7,Branch7,BARB0IFSC7,MICR7,Branch_Address7,28-11-2023,17:45:00,28-11-2023,Salary Credit,,,65000.0,184750.0
410,Customer7,1234500007,c7@gmail.com,7,Savings ,Customer_Address7,Branch7,BARB0IFSC7,MICR7,Branch_Address7,30-11-2023,20:10:00,30-11-2023,Online Shopping - Amazon,,3500.0,,181250.0
411,Customer7,1234500007,c7@gmail.com,7,Savings ,Customer_Address7,Branch7,BARB0IFSC7,MICR7,Branch_Address7,05-12-2023,13:25:00,05-12-2023,Electricity Bill Payment,,2200.0,,179050.0
412,Customer7,1234500007,c7@gmail.com,7,Savings ,Customer_Address7,Branch7,BARB0IFSC7,MICR7,Branch_Address7,09-12-2023,11:30:00,09-12-2023,ATM Withdrawal - Andheri East,,7000.0,,172050.0
413,Customer7,1234500007,c7@gmail.com,7,Savings ,Customer_Address7,Branch7,BARB0IFSC7,MICR7,Branch_Address7,14-12-2023,15:40:00,14-12-2023,UPI-SWIGGY-ORDER67890,,950.0,,171100.0
414,Customer7,1234500007,c7@gmail.com,7,Savings ,Customer_Address7,Branch7,BARB0IFSC7,MICR7,Branch_Address7,19-12-2023,9:15:00,19-12-2023,NEFT-ICICI-xxxxxxxxxx1234-Home Rent,,22000.0,,149100.0
415,Customer7,1234500007,c7@gmail.com,7,Savings ,Customer_Address7,Branch7,BARB0IFSC7,MICR7,Branch_Address7,22-12-2023,14:00:00,22-12-2023,IMPS-HDFC-xxxxxxxxxx5678-Car EMI,,12500.0,,136600.0
416,Customer7,1234500007,c7@gmail.com,7,Savings ,Customer_Address7,Branch7,BARB0IFSC7,MICR7,Branch_Address7,26-12-2023,16:30:00,26-12-2023,Cheque Payment,789012.0,15000.0,,121600.0
417,Customer7,1234500007,c7@gmail.com,7,Savings ,Customer_Address7,Branch7,BARB0IFSC7,MICR7,Branch_Address7,28-12-2023,9:30:00,28-12-2023,Salary Credit,,,65000.0,186600.0
418,Customer7,1234500007,c7@gmail.com,7,Savings ,Customer_Address7,Branch7,BARB0IFSC7,MICR7,Branch_Address7,31-12-2023,23:59:00,31-12-2023,Quarterly Interest Credit,,,1866.0,188466.0
419,Customer7,1234500007,c7@gmail.com,7,Savings ,Customer_Address7,Branch7,BARB0IFSC7,MICR7,Branch_Address7,03-01-2024,10:20:00,03-01-2024,New Year Shopping,,8500.0,,179966.0
420,Customer7,1234500007,c7@gmail.com,7,Savings ,Customer_Address7,Branch7,BARB0IFSC7,MICR7,Branch_Address7,08-01-2024,12:45:00,08-01-2024,Mobile Recharge,,999.0,,178967.0
421,Customer7,1234500007,c7@gmail.com,7,Savings ,Customer_Address7,Branch7,BARB0IFSC7,MICR7,Branch_Address7,13-01-2024,16:15:00,13-01-2024,ATM Withdrawal - Bandra West,,6000.0,,172967.0
422,Customer7,1234500007,c7@gmail.com,7,Savings ,Customer_Address7,Branch7,BARB0IFSC7,MICR7,Branch_Address7,17-01-2024,9:30:00,17-01-2024,NEFT-ICICI-xxxxxxxxxx1234-Home Rent,,22000.0,,150967.0
423,Customer7,1234500007,c7@gmail.com,7,Savings ,Customer_Address7,Branch7,BARB0IFSC7,MICR7,Branch_Address7,22-01-2024,14:10:00,22-01-2024,IMPS-HDFC-xxxxxxxxxx5678-Car EMI,,12500.0,,138467.0
424,Customer7,1234500007,c7@gmail.com,7,Savings ,Customer_Address7,Branch7,BARB0IFSC7,MICR7,Branch_Address7,26-01-2024,11:00:00,26-01-2024,UPI-BOOKMYSHOW-MOVIE123,,1200.0,,137267.0
425,Customer7,1234500007,c7@gmail.com,7,Savings ,Customer_Address7,Branch7,BARB0IFSC7,MICR7,Branch_Address7,28-01-2024,9:30:00,28-01-2024,Salary Credit,,,65000.0,202267.0
426,Customer7,1234500007,c7@gmail.com,7,Savings ,Customer_Address7,Branch7,BARB0IFSC7,MICR7,Branch_Address7,02-02-2024,15:30:00,02-02-2024,Gym Membership Renewal,,12000.0,,190267.0
427,Customer7,1234500007,c7@gmail.com,7,Savings ,Customer_Address7,Branch7,BARB0IFSC7,MICR7,Branch_Address7,07-02-2024,13:20:00,07-02-2024,Electricity Bill Payment,,2400.0,,187867.0
428,Customer7,1234500007,c7@gmail.com,7,Savings ,Customer_Address7,Branch7,BARB0IFSC7,MICR7,Branch_Address7,12-02-2024,10:45:00,12-02-2024,ATM Withdrawal - Goregaon,,5000.0,,182867.0
429,Customer7,1234500007,c7@gmail.com,7,Savings ,Customer_Address7,Branch7,BARB0IFSC7,MICR7,Branch_Address7,17-02-2024,16:00:00,17-02-2024,NEFT-ICICI-xxxxxxxxxx1234-Home Rent,,22000.0,,160867.0
430,Customer7,1234500007,c7@gmail.com,7,Savings ,Customer_Address7,Branch7,BARB0IFSC7,MICR7,Branch_Address7,22-02-2024,9:30:00,22-02-2024,IMPS-HDFC-xxxxxxxxxx5678-Car EMI,,12500.0,,148367.0
431,Customer7,1234500007,c7@gmail.com,7,Savings ,Customer_Address7,Branch7,BARB0IFSC7,MICR7,Branch_Address7,26-02-2024,14:15:00,26-02-2024,Online Shopping - Flipkart,,4500.0,,143867.0
432,Customer7,1234500007,c7@gmail.com,7,Savings ,Customer_Address7,Branch7,BARB0IFSC7,MICR7,Branch_Address7,28-02-2024,9:30:00,28-02-2024,Salary Credit,,,65000.0,208867.0
433,Customer7,1234500007,c7@gmail.com,7,Savings ,Customer_Address7,Branch7,BARB0IFSC7,MICR7,Branch_Address7,04-03-2024,11:30:00,04-03-2024,Health Insurance Premium,,18000.0,,190867.0
434,Customer7,1234500007,c7@gmail.com,7,Savings ,Customer_Address7,Branch7,BARB0IFSC7,MICR7,Branch_Address7,09-03-2024,15:45:00,09-03-2024,ATM Withdrawal - Vile Parle,,6000.0,,184867.0
435,Customer7,1234500007,c7@gmail.com,7,Savings ,Customer_Address7,Branch7,BARB0IFSC7,MICR7,Branch_Address7,14-03-2024,10:20:00,14-03-2024,Mobile Bill Payment,,1299.0,,183568.0
436,Customer7,1234500007,c7@gmail.com,7,Savings ,Customer_Address7,Branch7,BARB0IFSC7,MICR7,Branch_Address7,18-03-2024,9:30:00,18-03-2024,NEFT-ICICI-xxxxxxxxxx1234-Home Rent,,22000.0,,161568.0
437,Customer7,1234500007,c7@gmail.com,7,Savings ,Customer_Address7,Branch7,BARB0IFSC7,MICR7,Branch_Address7,22-03-2024,14:00:00,22-03-2024,IMPS-HDFC-xxxxxxxxxx5678-Car EMI,,12500.0,,149068.0
438,Customer7,1234500007,c7@gmail.com,7,Savings ,Customer_Address7,Branch7,BARB0IFSC7,MICR7,Branch_Address7,26-03-2024,16:30:00,26-03-2024,UPI-ZOMATO-ORDER54321,,850.0,,148218.0
439,Customer7,1234500007,c7@gmail.com,7,Savings ,Customer_Address7,Branch7,BARB0IFSC7,MICR7,Branch_Address7,28-03-2024,9:30:00,28-03-2024,Salary Credit,,,65000.0,213218.0
440,Customer7,1234500007,c7@gmail.com,7,Savings ,Customer_Address7,Branch7,BARB0IFSC7,MICR7,Branch_Address7,31-03-2024,23:59:00,31-03-2024,Quarterly Interest Credit,,,2132.18,215350.18
441,Customer7,1234500007,c7@gmail.com,7,Savings ,Customer_Address7,Branch7,BARB0IFSC7,MICR7,Branch_Address7,03-04-2024,12:15:00,03-04-2024,Electricity Bill Payment,,2600.0,,212750.18
442,Customer7,1234500007,c7@gmail.com,7,Savings ,Customer_Address7,Branch7,BARB0IFSC7,MICR7,Branch_Address7,08-04-2024,10:30:00,08-04-2024,ATM Withdrawal - Dadar,,7000.0,,205750.18
443,Customer7,1234500007,c7@gmail.com,7,Savings ,Customer_Address7,Branch7,BARB0IFSC7,MICR7,Branch_Address7,13-04-2024,14:45:00,13-04-2024,Online Shopping - Myntra,,3500.0,,202250.18
444,Customer7,1234500007,c7@gmail.com,7,Savings ,Customer_Address7,Branch7,BARB0IFSC7,MICR7,Branch_Address7,17-04-2024,9:30:00,17-04-2024,NEFT-ICICI-xxxxxxxxxx1234-Home Rent,,22000.0,,180250.18
445,Customer7,1234500007,c7@gmail.com,7,Savings ,Customer_Address7,Branch7,BARB0IFSC7,MICR7,Branch_Address7,22-04-2024,14:00:00,22-04-2024,IMPS-HDFC-xxxxxxxxxx5678-Car EMI,,12500.0,,167750.18
446,Customer7,1234500007,c7@gmail.com,7,Savings ,Customer_Address7,Branch7,BARB0IFSC7,MICR7,Branch_Address7,26-04-2024,16:20:00,26-04-2024,UPI-SWIGGY-ORDER98765,,1100.0,,166650.18
447,Customer7,1234500007,c7@gmail.com,7,Savings ,Customer_Address7,Branch7,BARB0IFSC7,MICR7,Branch_Address7,28-04-2024,9:30:00,28-04-2024,Salary Credit,,,65000.0,231650.18
448,Customer7,1234500007,c7@gmail.com,7,Savings ,Customer_Address7,Branch7,BARB0IFSC7,MICR7,Branch_Address7,03-05-2024,11:00:00,03-05-2024,Travel Booking - MakeMyTrip,,25000.0,,206650.18
449,Customer7,1234500007,c7@gmail.com,7,Savings ,Customer_Address7,Branch7,BARB0IFSC7,MICR7,Branch_Address7,08-05-2024,15:30:00,08-05-2024,ATM Withdrawal - Chembur,,5000.0,,201650.18
450,Customer7,1234500007,c7@gmail.com,7,Savings ,Customer_Address7,Branch7,BARB0IFSC7,MICR7,Branch_Address7,13-05-2024,10:45:00,13-05-2024,Mobile Recharge,,999.0,,200651.18
451,Customer7,1234500007,c7@gmail.com,7,Savings ,Customer_Address7,Branch7,BARB0IFSC7,MICR7,Branch_Address7,17-05-2024,9:30:00,17-05-2024,NEFT-ICICI-xxxxxxxxxx1234-Home Rent,,22000.0,,178651.18
452,Customer7,1234500007,c7@gmail.com,7,Savings ,Customer_Address7,Branch7,BARB0IFSC7,MICR7,Branch_Address7,22-05-2024,14:00:00,22-05-2024,IMPS-HDFC-xxxxxxxxxx5678-Car EMI,,12500.0,,166151.18
453,Customer7,1234500007,c7@gmail.com,7,Savings ,Customer_Address7,Branch7,BARB0IFSC7,MICR7,Branch_Address7,26-05-2024,16:45:00,26-05-2024,UPI-BOOKMYSHOW-MOVIE456,,1500.0,,164651.18
454,Customer7,1234500007,c7@gmail.com,7,Savings ,Customer_Address7,Branch7,BARB0IFSC7,MICR7,Branch_Address7,28-05-2024,9:30:00,28-05-2024,Salary Credit,,,65000.0,229651.18
455,Customer7,1234500007,c7@gmail.com,7,Savings ,Customer_Address7,Branch7,BARB0IFSC7,MICR7,Branch_Address7,02-06-2024,13:20:00,02-06-2024,Electricity Bill Payment,,2800.0,,226851.18
456,Customer7,1234500007,c7@gmail.com,7,Savings ,Customer_Address7,Branch7,BARB0IFSC7,MICR7,Branch_Address7,07-06-2024,11:15:00,07-06-2024,ATM Withdrawal - Powai,,6000.0,,220851.18
457,Customer7,1234500007,c7@gmail.com,7,Savings ,Customer_Address7,Branch7,BARB0IFSC7,MICR7,Branch_Address7,12-06-2024,15:00:00,12-06-2024,Online Shopping - Amazon,,4200.0,,216651.18
458,Customer7,1234500007,c7@gmail.com,7,Savings ,Customer_Address7,Branch7,BARB0IFSC7,MICR7,Branch_Address7,17-06-2024,9:30:00,17-06-2024,NEFT-ICICI-xxxxxxxxxx1234-Home Rent,,22000.0,,194651.18
459,Customer7,1234500007,c7@gmail.com,7,Savings ,Customer_Address7,Branch7,BARB0IFSC7,MICR7,Branch_Address7,22-06-2024,14:00:00,22-06-2024,IMPS-HDFC-xxxxxxxxxx5678-Car EMI,,12500.0,,182151.18
460,Customer7,1234500007,c7@gmail.com,7,Savings ,Customer_Address7,Branch7,BARB0IFSC7,MICR7,Branch_Address7,26-06-2024,16:30:00,26-06-2024,UPI-ZOMATO-ORDER13579,,950.0,,181201.18
461,Customer7,1234500007,c7@gmail.com,7,Savings ,Customer_Address7,Branch7,BARB0IFSC7,MICR7,Branch_Address7,28-06-2024,9:30:00,28-06-2024,Salary Credit,,,65000.0,246201.18
462,Customer7,1234500007,c7@gmail.com,7,Savings ,Customer_Address7,Branch7,BARB0IFSC7,MICR7,Branch_Address7,30-06-2024,23:59:00,30-06-2024,Quarterly Interest Credit,,,2462.01,248663.19
463,Customer7,1234500007,c7@gmail.com,7,Savings ,Customer_Address7,Branch7,BARB0IFSC7,MICR7,Branch_Address7,03-07-2024,10:45:00,03-07-2024,Mobile Bill Payment,,1399.0,,247264.19
464,Customer7,1234500007,c7@gmail.com,7,Savings ,Customer_Address7,Branch7,BARB0IFSC7,MICR7,Branch_Address7,08-07-2024,14:30:00,08-07-2024,ATM Withdrawal - Juhu,,8000.0,,239264.19
465,Customer7,1234500007,c7@gmail.com,7,Savings ,Customer_Address7,Branch7,BARB0IFSC7,MICR7,Branch_Address7,13-07-2024,11:20:00,13-07-2024,UPI-SWIGGY-ORDER24680,,1300.0,,237964.19
466,Customer7,1234500007,c7@gmail.com,7,Savings ,Customer_Address7,Branch7,BARB0IFSC7,MICR7,Branch_Address7,17-07-2024,9:30:00,17-07-2024,NEFT-ICICI-xxxxxxxxxx1234-Home Rent,,22000.0,,215964.19
467,Customer7,1234500007,c7@gmail.com,7,Savings ,Customer_Address7,Branch7,BARB0IFSC7,MICR7,Branch_Address7,22-07-2024,14:00:00,22-07-2024,IMPS-HDFC-xxxxxxxxxx5678-Car EMI,,12500.0,,203464.19
468,Customer7,1234500007,c7@gmail.com,7,Savings ,Customer_Address7,Branch7,BARB0IFSC7,MICR7,Branch_Address7,26-07-2024,16:15:00,26-07-2024,Online Shopping - Flipkart,,5500.0,,197964.19
469,Customer7,1234500007,c7@gmail.com,7,Savings ,Customer_Address7,Branch7,BARB0IFSC7,MICR7,Branch_Address7,28-07-2024,9:30:00,28-07-2024,Salary Credit,,,65000.0,262964.19
470,Customer8,1234500008,c8@gmail.com,8,Savings ,Customer_Address8,Branch8,BARB0IFSC8,MICR8,Branch_Address8,01-01-2024,9:15:00,01-01-2024,Cash Deposit,,,100000.0,100000.0
471,Customer8,1234500008,c8@gmail.com,8,Savings ,Customer_Address8,Branch8,BARB0IFSC8,MICR8,Branch_Address8,03-01-2024,14:30:00,03-01-2024,ATM Withdrawal,,5000.0,,95000.0
472,Customer8,1234500008,c8@gmail.com,8,Savings ,Customer_Address8,Branch8,BARB0IFSC8,MICR8,Branch_Address8,07-01-2024,11:45:00,07-01-2024,Online Shopping - Amazon,,2399.0,,92601.0
473,Customer8,1234500008,c8@gmail.com,8,Savings ,Customer_Address8,Branch8,BARB0IFSC8,MICR8,Branch_Address8,12-01-2024,16:20:00,12-01-2024,Electricity Bill Payment,,1850.0,,90751.0
474,Customer8,1234500008,c8@gmail.com,8,Savings ,Customer_Address8,Branch8,BARB0IFSC8,MICR8,Branch_Address8,15-01-2024,10:00:00,15-01-2024,Salary Credit,,,65000.0,155751.0
475,Customer8,1234500008,c8@gmail.com,8,Savings ,Customer_Address8,Branch8,BARB0IFSC8,MICR8,Branch_Address8,18-01-2024,13:30:00,18-01-2024,Restaurant Payment,,1200.0,,154551.0
476,Customer8,1234500008,c8@gmail.com,8,Savings ,Customer_Address8,Branch8,BARB0IFSC8,MICR8,Branch_Address8,22-01-2024,9:45:00,22-01-2024,Mobile Recharge,,999.0,,153552.0
477,Customer8,1234500008,c8@gmail.com,8,Savings ,Customer_Address8,Branch8,BARB0IFSC8,MICR8,Branch_Address8,28-01-2024,17:00:00,28-01-2024,SIP Investment,,5000.0,,148552.0
478,Customer8,1234500008,c8@gmail.com,8,Savings ,Customer_Address8,Branch8,BARB0IFSC8,MICR8,Branch_Address8,02-02-2024,11:30:00,02-02-2024,Grocery Shopping,,3500.0,,145052.0
479,Customer8,1234500008,c8@gmail.com,8,Savings ,Customer_Address8,Branch8,BARB0IFSC8,MICR8,Branch_Address8,06-02-2024,14:15:00,06-02-2024,Movie Tickets,,600.0,,144452.0
480,Customer8,1234500008,c8@gmail.com,8,Savings ,Customer_Address8,Branch8,BARB0IFSC8,MICR8,Branch_Address8,10-02-2024,16:45:00,10-02-2024,Gas Bill Payment,,850.0,,143602.0
481,Customer8,1234500008,c8@gmail.com,8,Savings ,Customer_Address8,Branch8,BARB0IFSC8,MICR8,Branch_Address8,15-02-2024,10:00:00,15-02-2024,Salary Credit,,,65000.0,208602.0
482,Customer8,1234500008,c8@gmail.com,8,Savings ,Customer_Address8,Branch8,BARB0IFSC8,MICR8,Branch_Address8,19-02-2024,12:30:00,19-02-2024,Online Course Payment,,4999.0,,203603.0
483,Customer8,1234500008,c8@gmail.com,8,Savings ,Customer_Address8,Branch8,BARB0IFSC8,MICR8,Branch_Address8,23-02-2024,15:00:00,23-02-2024,Clothing Purchase,,3200.0,,200403.0
484,Customer8,1234500008,c8@gmail.com,8,Savings ,Customer_Address8,Branch8,BARB0IFSC8,MICR8,Branch_Address8,28-02-2024,17:00:00,28-02-2024,SIP Investment,,5000.0,,195403.0
485,Customer8,1234500008,c8@gmail.com,8,Savings ,Customer_Address8,Branch8,BARB0IFSC8,MICR8,Branch_Address8,04-03-2024,9:30:00,04-03-2024,Health Insurance Premium,,12000.0,,183403.0
486,Customer8,1234500008,c8@gmail.com,8,Savings ,Customer_Address8,Branch8,BARB0IFSC8,MICR8,Branch_Address8,08-03-2024,13:45:00,08-03-2024,Dentist Appointment,,2500.0,,180903.0
487,Customer8,1234500008,c8@gmail.com,8,Savings ,Customer_Address8,Branch8,BARB0IFSC8,MICR8,Branch_Address8,12-03-2024,16:20:00,12-03-2024,Electricity Bill Payment,,1920.0,,178983.0
488,Customer8,1234500008,c8@gmail.com,8,Savings ,Customer_Address8,Branch8,BARB0IFSC8,MICR8,Branch_Address8,15-03-2024,10:00:00,15-03-2024,Salary Credit,,,65000.0,243983.0
489,Customer8,1234500008,c8@gmail.com,8,Savings ,Customer_Address8,Branch8,BARB0IFSC8,MICR8,Branch_Address8,20-03-2024,11:30:00,20-03-2024,Flight Tickets,,15000.0,,228983.0
490,Customer8,1234500008,c8@gmail.com,8,Savings ,Customer_Address8,Branch8,BARB0IFSC8,MICR8,Branch_Address8,25-03-2024,14:00:00,25-03-2024,Home Appliance Purchase,,22000.0,,206983.0
491,Customer8,1234500008,c8@gmail.com,8,Savings ,Customer_Address8,Branch8,BARB0IFSC8,MICR8,Branch_Address8,28-03-2024,17:00:00,28-03-2024,SIP Investment,,5000.0,,201983.0
492,Customer8,1234500008,c8@gmail.com,8,Savings ,Customer_Address8,Branch8,BARB0IFSC8,MICR8,Branch_Address8,31-03-2024,23:59:59,31-03-2024,Quarterly Interest Credit,,,2019.83,204002.83
493,Customer8,1234500008,c8@gmail.com,8,Savings ,Customer_Address8,Branch8,BARB0IFSC8,MICR8,Branch_Address8,03-04-2024,10:15:00,03-04-2024,ATM Withdrawal,,10000.0,,194002.83
494,Customer8,1234500008,c8@gmail.com,8,Savings ,Customer_Address8,Branch8,BARB0IFSC8,MICR8,Branch_Address8,07-04-2024,12:45:00,07-04-2024,Restaurant Payment,,1800.0,,192202.83
495,Customer8,1234500008,c8@gmail.com,8,Savings ,Customer_Address8,Branch8,BARB0IFSC8,MICR8,Branch_Address8,11-04-2024,15:30:00,11-04-2024,Mobile Bill Payment,,999.0,,191203.83
496,Customer8,1234500008,c8@gmail.com,8,Savings ,Customer_Address8,Branch8,BARB0IFSC8,MICR8,Branch_Address8,15-04-2024,10:00:00,15-04-2024,Salary Credit,,,65000.0,256203.83
497,Customer8,1234500008,c8@gmail.com,8,Savings ,Customer_Address8,Branch8,BARB0IFSC8,MICR8,Branch_Address8,19-04-2024,14:20:00,19-04-2024,Online Shopping - Flipkart,,4500.0,,251703.83
498,Customer8,1234500008,c8@gmail.com,8,Savings ,Customer_Address8,Branch8,BARB0IFSC8,MICR8,Branch_Address8,23-04-2024,16:45:00,23-04-2024,Car Service,,7500.0,,244203.83
499,Customer8,1234500008,c8@gmail.com,8,Savings ,Customer_Address8,Branch8,BARB0IFSC8,MICR8,Branch_Address8,28-04-2024,17:00:00,28-04-2024,SIP Investment,,5000.0,,239203.83
500,Customer8,1234500008,c8@gmail.com,8,Savings ,Customer_Address8,Branch8,BARB0IFSC8,MICR8,Branch_Address8,02-05-2024,9:30:00,02-05-2024,Grocery Shopping,,4200.0,,235003.83
501,Customer8,1234500008,c8@gmail.com,8,Savings ,Customer_Address8,Branch8,BARB0IFSC8,MICR8,Branch_Address8,06-05-2024,13:15:00,06-05-2024,Gift Purchase,,3000.0,,232003.83
502,Customer8,1234500008,c8@gmail.com,8,Savings ,Customer_Address8,Branch8,BARB0IFSC8,MICR8,Branch_Address8,10-05-2024,15:45:00,10-05-2024,Gas Bill Payment,,920.0,,231083.83
503,Customer8,1234500008,c8@gmail.com,8,Savings ,Customer_Address8,Branch8,BARB0IFSC8,MICR8,Branch_Address8,15-05-2024,10:00:00,15-05-2024,Salary Credit,,,65000.0,296083.83
504,Customer8,1234500008,c8@gmail.com,8,Savings ,Customer_Address8,Branch8,BARB0IFSC8,MICR8,Branch_Address8,19-05-2024,11:30:00,19-05-2024,Gym Membership Renewal,,12000.0,,284083.83
505,Customer8,1234500008,c8@gmail.com,8,Savings ,Customer_Address8,Branch8,BARB0IFSC8,MICR8,Branch_Address8,23-05-2024,14:00:00,23-05-2024,Furniture Purchase,,35000.0,,249083.83
506,Customer8,1234500008,c8@gmail.com,8,Savings ,Customer_Address8,Branch8,BARB0IFSC8,MICR8,Branch_Address8,28-05-2024,17:00:00,28-05-2024,SIP Investment,,5000.0,,244083.83
507,Customer8,1234500008,c8@gmail.com,8,Savings ,Customer_Address8,Branch8,BARB0IFSC8,MICR8,Branch_Address8,02-06-2024,10:15:00,02-06-2024,ATM Withdrawal,,8000.0,,236083.83
508,Customer8,1234500008,c8@gmail.com,8,Savings ,Customer_Address8,Branch8,BARB0IFSC8,MICR8,Branch_Address8,06-06-2024,12:45:00,06-06-2024,Restaurant Payment,,2200.0,,233883.83
509,Customer8,1234500008,c8@gmail.com,8,Savings ,Customer_Address8,Branch8,BARB0IFSC8,MICR8,Branch_Address8,10-06-2024,15:30:00,10-06-2024,Electricity Bill Payment,,2100.0,,231783.83
510,Customer8,1234500008,c8@gmail.com,8,Savings ,Customer_Address8,Branch8,BARB0IFSC8,MICR8,Branch_Address8,15-06-2024,10:00:00,15-06-2024,Salary Credit,,,65000.0,296783.83
511,Customer8,1234500008,c8@gmail.com,8,Savings ,Customer_Address8,Branch8,BARB0IFSC8,MICR8,Branch_Address8,19-06-2024,14:20:00,19-06-2024,Mobile Phone Purchase,,25000.0,,271783.83
512,Customer8,1234500008,c8@gmail.com,8,Savings ,Customer_Address8,Branch8,BARB0IFSC8,MICR8,Branch_Address8,23-06-2024,16:45:00,23-06-2024,Hotel Booking,,18000.0,,253783.83
513,Customer8,1234500008,c8@gmail.com,8,Savings ,Customer_Address8,Branch8,BARB0IFSC8,MICR8,Branch_Address8,28-06-2024,17:00:00,28-06-2024,SIP Investment,,5000.0,,248783.83
514,Customer8,1234500008,c8@gmail.com,8,Savings ,Customer_Address8,Branch8,BARB0IFSC8,MICR8,Branch_Address8,30-06-2024,23:59:59,30-06-2024,Quarterly Interest Credit,,,2487.84,251271.67
515,Customer8,1234500008,c8@gmail.com,8,Savings ,Customer_Address8,Branch8,BARB0IFSC8,MICR8,Branch_Address8,03-07-2024,9:45:00,03-07-2024,Grocery Shopping,,3800.0,,247471.67
516,Customer8,1234500008,c8@gmail.com,8,Savings ,Customer_Address8,Branch8,BARB0IFSC8,MICR8,Branch_Address8,07-07-2024,13:30:00,07-07-2024,Movie Tickets,,750.0,,246721.67
517,Customer8,1234500008,c8@gmail.com,8,Savings ,Customer_Address8,Branch8,BARB0IFSC8,MICR8,Branch_Address8,11-07-2024,16:15:00,11-07-2024,Gas Bill Payment,,980.0,,245741.67
518,Customer8,1234500008,c8@gmail.com,8,Savings ,Customer_Address8,Branch8,BARB0IFSC8,MICR8,Branch_Address8,15-07-2024,10:00:00,15-07-2024,Salary Credit,,,65000.0,310741.67
519,Customer8,1234500008,c8@gmail.com,8,Savings ,Customer_Address8,Branch8,BARB0IFSC8,MICR8,Branch_Address8,19-07-2024,11:45:00,19-07-2024,Online Transfer Nigeria,,155999.0,,154742.67
520,Customer8,1234500008,c8@gmail.com,8,Savings ,Customer_Address8,Branch8,BARB0IFSC8,MICR8,Branch_Address8,28-07-2024,17:00:00,28-07-2024,SIP Investment,,5000.0,,145242.67
521,Customer8,1234500008,c8@gmail.com,8,Savings ,Customer_Address8,Branch8,BARB0IFSC8,MICR8,Branch_Address8,31-07-2024,12:00:00,31-07-2024,Cheque Deposit,123456.0,,20000.0,165242.67
522,Customer8,1234500008,c8@gmail.com,8,Savings ,Customer_Address8,Branch8,BARB0IFSC8,MICR8,Branch_Address8,31-07-2024,11:45:00,31-07-2024,Online Transfer Nigeria,,155999.0,,9243.67
523,Customer9,1234500009,c9@gmail.com,9,Savings ,Customer_Address9,Branch9,BARB0IFSC9,MICR9,Branch_Address9,03-04-2024,14:30:00,03-04-2024,ATM Withdrawal,,5000.0,,145000.0
524,Customer9,1234500009,c9@gmail.com,9,Savings ,Customer_Address9,Branch9,BARB0IFSC9,MICR9,Branch_Address9,05-04-2024,11:45:00,05-04-2024,Online Shopping - Amazon,,2500.0,,142500.0
525,Customer9,1234500009,c9@gmail.com,9,Savings ,Customer_Address9,Branch9,BARB0IFSC9,MICR9,Branch_Address9,10-04-2024,16:20:00,10-04-2024,Salary Credit,,,65000.0,207500.0
526,Customer9,1234500009,c9@gmail.com,9,Savings ,Customer_Address9,Branch9,BARB0IFSC9,MICR9,Branch_Address9,12-04-2024,10:30:00,12-04-2024,Electricity Bill Payment,,3200.0,,204300.0
527,Customer9,1234500009,c9@gmail.com,9,Savings ,Customer_Address9,Branch9,BARB0IFSC9,MICR9,Branch_Address9,15-04-2024,13:45:00,15-04-2024,SIP Investment,,10000.0,,194300.0
528,Customer9,1234500009,c9@gmail.com,9,Savings ,Customer_Address9,Branch9,BARB0IFSC9,MICR9,Branch_Address9,18-04-2024,9:00:00,18-04-2024,Grocery Shopping,,4500.0,,189800.0
529,Customer9,1234500009,c9@gmail.com,9,Savings ,Customer_Address9,Branch9,BARB0IFSC9,MICR9,Branch_Address9,22-04-2024,17:30:00,22-04-2024,Mobile Recharge,,999.0,,188801.0
530,Customer9,1234500009,c9@gmail.com,9,Savings ,Customer_Address9,Branch9,BARB0IFSC9,MICR9,Branch_Address9,28-04-2024,12:15:00,28-04-2024,Restaurant Bill,,3500.0,,185301.0
531,Customer9,1234500009,c9@gmail.com,9,Savings ,Customer_Address9,Branch9,BARB0IFSC9,MICR9,Branch_Address9,02-05-2024,10:00:00,02-05-2024,ATM Withdrawal,,7000.0,,178301.0
532,Customer9,1234500009,c9@gmail.com,9,Savings ,Customer_Address9,Branch9,BARB0IFSC9,MICR9,Branch_Address9,05-05-2024,14:45:00,05-05-2024,Online Shopping - Flipkart,,3800.0,,174501.0
533,Customer9,1234500009,c9@gmail.com,9,Savings ,Customer_Address9,Branch9,BARB0IFSC9,MICR9,Branch_Address9,10-05-2024,16:30:00,10-05-2024,Salary Credit,,,65000.0,239501.0
534,Customer9,1234500009,c9@gmail.com,9,Savings ,Customer_Address9,Branch9,BARB0IFSC9,MICR9,Branch_Address9,13-05-2024,11:00:00,13-05-2024,Gas Bill Payment,,1200.0,,238301.0
535,Customer9,1234500009,c9@gmail.com,9,Savings ,Customer_Address9,Branch9,BARB0IFSC9,MICR9,Branch_Address9,15-05-2024,13:45:00,15-05-2024,SIP Investment,,10000.0,,228301.0
536,Customer9,1234500009,c9@gmail.com,9,Savings ,Customer_Address9,Branch9,BARB0IFSC9,MICR9,Branch_Address9,18-05-2024,15:20:00,18-05-2024,Movie Tickets,,1500.0,,226801.0
537,Customer9,1234500009,c9@gmail.com,9,Savings ,Customer_Address9,Branch9,BARB0IFSC9,MICR9,Branch_Address9,22-05-2024,9:30:00,22-05-2024,Cheque Deposit,123456.0,,20000.0,246801.0
538,Customer9,1234500009,c9@gmail.com,9,Savings ,Customer_Address9,Branch9,BARB0IFSC9,MICR9,Branch_Address9,26-05-2024,12:00:00,26-05-2024,Health Insurance Premium,,12000.0,,234801.0
539,Customer9,1234500009,c9@gmail.com,9,Savings ,Customer_Address9,Branch9,BARB0IFSC9,MICR9,Branch_Address9,30-05-2024,16:45:00,30-05-2024,Train Ticket Booking,,3500.0,,231301.0
540,Customer9,1234500009,c9@gmail.com,9,Savings ,Customer_Address9,Branch9,BARB0IFSC9,MICR9,Branch_Address9,03-06-2024,10:15:00,03-06-2024,ATM Withdrawal,,6000.0,,225301.0
541,Customer9,1234500009,c9@gmail.com,9,Savings ,Customer_Address9,Branch9,BARB0IFSC9,MICR9,Branch_Address9,06-06-2024,14:00:00,06-06-2024,Online Course Payment,,8000.0,,217301.0
542,Customer9,1234500009,c9@gmail.com,9,Savings ,Customer_Address9,Branch9,BARB0IFSC9,MICR9,Branch_Address9,10-06-2024,16:30:00,10-06-2024,Salary Credit,,,65000.0,282301.0
543,Customer9,1234500009,c9@gmail.com,9,Savings ,Customer_Address9,Branch9,BARB0IFSC9,MICR9,Branch_Address9,12-06-2024,11:30:00,12-06-2024,Electricity Bill Payment,,3500.0,,278801.0
544,Customer9,1234500009,c9@gmail.com,9,Savings ,Customer_Address9,Branch9,BARB0IFSC9,MICR9,Branch_Address9,15-06-2024,13:45:00,15-06-2024,SIP Investment,,10000.0,,268801.0
545,Customer9,1234500009,c9@gmail.com,9,Savings ,Customer_Address9,Branch9,BARB0IFSC9,MICR9,Branch_Address9,18-06-2024,9:45:00,18-06-2024,Grocery Shopping,,5200.0,,263601.0
546,Customer9,1234500009,c9@gmail.com,9,Savings ,Customer_Address9,Branch9,BARB0IFSC9,MICR9,Branch_Address9,22-06-2024,17:00:00,22-06-2024,Mobile Recharge,,1499.0,,262102.0
547,Customer9,1234500009,c9@gmail.com,9,Savings ,Customer_Address9,Branch9,BARB0IFSC9,MICR9,Branch_Address9,26-06-2024,12:30:00,26-06-2024,Car Service,,7500.0,,254602.0
548,Customer9,1234500009,c9@gmail.com,9,Savings ,Customer_Address9,Branch9,BARB0IFSC9,MICR9,Branch_Address9,30-06-2024,18:00:00,30-06-2024,Quarterly Interest Credit,,,2546.02,257148.02
549,Customer9,1234500009,c9@gmail.com,9,Savings ,Customer_Address9,Branch9,BARB0IFSC9,MICR9,Branch_Address9,02-07-2024,10:30:00,02-07-2024,ATM Withdrawal,,8000.0,,249148.02
550,Customer9,1234500009,c9@gmail.com,9,Savings ,Customer_Address9,Branch9,BARB0IFSC9,MICR9,Branch_Address9,05-07-2024,15:15:00,05-07-2024,Online Shopping - Myntra,,4500.0,,244648.02
551,Customer9,1234500009,c9@gmail.com,9,Savings ,Customer_Address9,Branch9,BARB0IFSC9,MICR9,Branch_Address9,10-07-2024,16:30:00,10-07-2024,Salary Credit,,,65000.0,309648.02
552,Customer9,1234500009,c9@gmail.com,9,Savings ,Customer_Address9,Branch9,BARB0IFSC9,MICR9,Branch_Address9,13-07-2024,11:15:00,13-07-2024,Gas Bill Payment,,1300.0,,308348.02
553,Customer9,1234500009,c9@gmail.com,9,Savings ,Customer_Address9,Branch9,BARB0IFSC9,MICR9,Branch_Address9,15-07-2024,13:45:00,15-07-2024,SIP Investment,,10000.0,,298348.02
554,Customer9,1234500009,c9@gmail.com,9,Savings ,Customer_Address9,Branch9,BARB0IFSC9,MICR9,Branch_Address9,18-07-2024,14:00:00,18-07-2024,Dentist Appointment,,5000.0,,293348.02
555,Customer9,1234500009,c9@gmail.com,9,Savings ,Customer_Address9,Branch9,BARB0IFSC9,MICR9,Branch_Address9,22-07-2024,9:00:00,22-07-2024,Cheque Payment,789012.0,15000.0,,278348.02
556,Customer9,1234500009,c9@gmail.com,9,Savings ,Customer_Address9,Branch9,BARB0IFSC9,MICR9,Branch_Address9,26-07-2024,12:45:00,26-07-2024,Home Internet Bill,,1999.0,,276349.02
557,Customer9,1234500009,c9@gmail.com,9,Savings ,Customer_Address9,Branch9,BARB0IFSC9,MICR9,Branch_Address9,30-07-2024,16:30:00,30-07-2024,Flight Ticket Booking,,12000.0,,264349.02
558,Customer10,1234500010,c10@gmail.com,10,Savings ,Customer_Address10,Branch10,BARB0IFSC10,MICR10,Branch_Address10,18-09-2023,14:30:45,18-09-2023,Electricity Bill Payment,,1250.0,,48750.0
559,Customer10,1234500010,c10@gmail.com,10,Savings ,Customer_Address10,Branch10,BARB0IFSC10,MICR10,Branch_Address10,22-09-2023,11:15:30,22-09-2023,ATM Withdrawal,,5000.0,,43750.0
560,Customer10,1234500010,c10@gmail.com,10,Savings ,Customer_Address10,Branch10,BARB0IFSC10,MICR10,Branch_Address10,25-09-2023,16:45:22,25-09-2023,Online Shopping - Amazon,,3500.0,,40250.0
561,Customer10,1234500010,c10@gmail.com,10,Savings ,Customer_Address10,Branch10,BARB0IFSC10,MICR10,Branch_Address10,30-09-2023,9:30:00,30-09-2023,Salary Credit,,,65000.0,105250.0
562,Customer10,1234500010,c10@gmail.com,10,Savings ,Customer_Address10,Branch10,BARB0IFSC10,MICR10,Branch_Address10,01-10-2023,10:00:15,01-10-2023,SIP Investment,,10000.0,,95250.0
563,Customer10,1234500010,c10@gmail.com,10,Savings ,Customer_Address10,Branch10,BARB0IFSC10,MICR10,Branch_Address10,05-10-2023,13:20:40,05-10-2023,Mobile Recharge,,999.0,,94251.0
564,Customer10,1234500010,c10@gmail.com,10,Savings ,Customer_Address10,Branch10,BARB0IFSC10,MICR10,Branch_Address10,10-10-2023,18:30:55,10-10-2023,Grocery Shopping,,3500.0,,90751.0
565,Customer10,1234500010,c10@gmail.com,10,Savings ,Customer_Address10,Branch10,BARB0IFSC10,MICR10,Branch_Address10,15-10-2023,20:45:30,15-10-2023,Restaurant Bill Payment,,2500.0,,88251.0
566,Customer10,1234500010,c10@gmail.com,10,Savings ,Customer_Address10,Branch10,BARB0IFSC10,MICR10,Branch_Address10,20-10-2023,11:00:00,20-10-2023,Cheque Deposit,123456.0,,25000.0,113251.0
567,Customer10,1234500010,c10@gmail.com,10,Savings ,Customer_Address10,Branch10,BARB0IFSC10,MICR10,Branch_Address10,31-10-2023,9:30:00,31-10-2023,Salary Credit,,,65000.0,178251.0
568,Customer10,1234500010,c10@gmail.com,10,Savings ,Customer_Address10,Branch10,BARB0IFSC10,MICR10,Branch_Address10,01-11-2023,10:00:15,01-11-2023,SIP Investment,,10000.0,,168251.0
569,Customer10,1234500010,c10@gmail.com,10,Savings ,Customer_Address10,Branch10,BARB0IFSC10,MICR10,Branch_Address10,05-11-2023,14:30:20,05-11-2023,Insurance Premium,,12000.0,,156251.0
570,Customer10,1234500010,c10@gmail.com,10,Savings ,Customer_Address10,Branch10,BARB0IFSC10,MICR10,Branch_Address10,12-11-2023,16:45:35,12-11-2023,Electricity Bill Payment,,1300.0,,154951.0
571,Customer10,1234500010,c10@gmail.com,10,Savings ,Customer_Address10,Branch10,BARB0IFSC10,MICR10,Branch_Address10,18-11-2023,9:15:50,18-11-2023,Online Course Fee,,15000.0,,139951.0
572,Customer10,1234500010,c10@gmail.com,10,Savings ,Customer_Address10,Branch10,BARB0IFSC10,MICR10,Branch_Address10,22-11-2023,12:30:00,22-11-2023,ATM Withdrawal,,7000.0,,132951.0
573,Customer10,1234500010,c10@gmail.com,10,Savings ,Customer_Address10,Branch10,BARB0IFSC10,MICR10,Branch_Address10,30-11-2023,9:30:00,30-11-2023,Salary Credit,,,65000.0,197951.0
574,Customer10,1234500010,c10@gmail.com,10,Savings ,Customer_Address10,Branch10,BARB0IFSC10,MICR10,Branch_Address10,01-12-2023,10:00:15,01-12-2023,SIP Investment,,10000.0,,187951.0
575,Customer10,1234500010,c10@gmail.com,10,Savings ,Customer_Address10,Branch10,BARB0IFSC10,MICR10,Branch_Address10,07-12-2023,15:20:30,07-12-2023,Flight Ticket Booking,,18000.0,,169951.0
576,Customer10,1234500010,c10@gmail.com,10,Savings ,Customer_Address10,Branch10,BARB0IFSC10,MICR10,Branch_Address10,12-12-2023,11:45:40,12-12-2023,Gas Bill Payment,,850.0,,169101.0
577,Customer10,1234500010,c10@gmail.com,10,Savings ,Customer_Address10,Branch10,BARB0IFSC10,MICR10,Branch_Address10,18-12-2023,17:30:55,18-12-2023,Clothing Purchase,,5500.0,,163601.0
578,Customer10,1234500010,c10@gmail.com,10,Savings ,Customer_Address10,Branch10,BARB0IFSC10,MICR10,Branch_Address10,23-12-2023,20:00:10,23-12-2023,Movie Tickets,,1200.0,,162401.0
579,Customer10,1234500010,c10@gmail.com,10,Savings ,Customer_Address10,Branch10,BARB0IFSC10,MICR10,Branch_Address10,28-12-2023,14:15:25,28-12-2023,Cheque Payment,789012.0,20000.0,,142401.0
580,Customer10,1234500010,c10@gmail.com,10,Savings ,Customer_Address10,Branch10,BARB0IFSC10,MICR10,Branch_Address10,30-12-2023,9:30:00,30-12-2023,Salary Credit,,,65000.0,207401.0
581,Customer10,1234500010,c10@gmail.com,10,Savings ,Customer_Address10,Branch10,BARB0IFSC10,MICR10,Branch_Address10,31-12-2023,23:59:59,31-12-2023,Quarterly Interest Credit,,,2074.01,209475.01
582,Customer10,1234500010,c10@gmail.com,10,Savings ,Customer_Address10,Branch10,BARB0IFSC10,MICR10,Branch_Address10,01-01-2024,10:00:15,01-01-2024,SIP Investment,,10000.0,,199475.01
583,Customer10,1234500010,c10@gmail.com,10,Savings ,Customer_Address10,Branch10,BARB0IFSC10,MICR10,Branch_Address10,08-01-2024,13:30:30,08-01-2024,Electricity Bill Payment,,1350.0,,198125.01
584,Customer10,1234500010,c10@gmail.com,10,Savings ,Customer_Address10,Branch10,BARB0IFSC10,MICR10,Branch_Address10,14-01-2024,16:45:45,14-01-2024,Home Appliance Purchase,,25000.0,,173125.01
585,Customer10,1234500010,c10@gmail.com,10,Savings ,Customer_Address10,Branch10,BARB0IFSC10,MICR10,Branch_Address10,20-01-2024,11:00:00,20-01-2024,ATM Withdrawal,,6000.0,,167125.01
586,Customer10,1234500010,c10@gmail.com,10,Savings ,Customer_Address10,Branch10,BARB0IFSC10,MICR10,Branch_Address10,26-01-2024,9:15:15,26-01-2024,Medical Expenses,,8500.0,,158625.01
587,Customer10,1234500010,c10@gmail.com,10,Savings ,Customer_Address10,Branch10,BARB0IFSC10,MICR10,Branch_Address10,31-01-2024,9:30:00,31-01-2024,Salary Credit,,,65000.0,223625.01
588,Customer10,1234500010,c10@gmail.com,10,Savings ,Customer_Address10,Branch10,BARB0IFSC10,MICR10,Branch_Address10,01-02-2024,10:00:15,01-02-2024,SIP Investment,,10000.0,,213625.01
589,Customer10,1234500010,c10@gmail.com,10,Savings ,Customer_Address10,Branch10,BARB0IFSC10,MICR10,Branch_Address10,07-02-2024,14:30:30,07-02-2024,Car Service,,7500.0,,206125.01
590,Customer10,1234500010,c10@gmail.com,10,Savings ,Customer_Address10,Branch10,BARB0IFSC10,MICR10,Branch_Address10,13-02-2024,16:45:45,13-02-2024,Electricity Bill Payment,,1280.0,,204845.01
591,Customer10,1234500010,c10@gmail.com,10,Savings ,Customer_Address10,Branch10,BARB0IFSC10,MICR10,Branch_Address10,19-02-2024,11:00:00,19-02-2024,Grocery Shopping,,4200.0,,200645.01
592,Customer10,1234500010,c10@gmail.com,10,Savings ,Customer_Address10,Branch10,BARB0IFSC10,MICR10,Branch_Address10,24-02-2024,18:15:15,24-02-2024,Restaurant Bill Payment,,3000.0,,197645.01
593,Customer10,1234500010,c10@gmail.com,10,Savings ,Customer_Address10,Branch10,BARB0IFSC10,MICR10,Branch_Address10,29-02-2024,9:30:00,29-02-2024,Salary Credit,,,65000.0,262645.01
594,Customer10,1234500010,c10@gmail.com,10,Savings ,Customer_Address10,Branch10,BARB0IFSC10,MICR10,Branch_Address10,01-03-2024,10:00:15,01-03-2024,SIP Investment,,10000.0,,252645.01
595,Customer10,1234500010,c10@gmail.com,10,Savings ,Customer_Address10,Branch10,BARB0IFSC10,MICR10,Branch_Address10,06-03-2024,13:30:30,06-03-2024,Mobile Recharge,,1099.0,,251546.01
596,Customer10,1234500010,c10@gmail.com,10,Savings ,Customer_Address10,Branch10,BARB0IFSC10,MICR10,Branch_Address10,12-03-2024,16:45:45,12-03-2024,Online Shopping - Flipkart,,5500.0,,246046.01
597,Customer10,1234500010,c10@gmail.com,10,Savings ,Customer_Address10,Branch10,BARB0IFSC10,MICR10,Branch_Address10,18-03-2024,11:00:00,18-03-2024,ATM Withdrawal,,8000.0,,238046.01
598,Customer10,1234500010,c10@gmail.com,10,Savings ,Customer_Address10,Branch10,BARB0IFSC10,MICR10,Branch_Address10,23-03-2024,14:15:15,23-03-2024,Clothing Purchase,,6500.0,,231546.01
599,Customer10,1234500010,c10@gmail.com,10,Savings ,Customer_Address10,Branch10,BARB0IFSC10,MICR10,Branch_Address10,28-03-2024,17:30:30,28-03-2024,Electricity Bill Payment,,1320.0,,230226.01
600,Customer10,1234500010,c10@gmail.com,10,Savings ,Customer_Address10,Branch10,BARB0IFSC10,MICR10,Branch_Address10,31-03-2024,9:30:00,31-03-2024,Salary Credit,,,65000.0,295226.01
601,Customer10,1234500010,c10@gmail.com,10,Savings ,Customer_Address10,Branch10,BARB0IFSC10,MICR10,Branch_Address10,31-03-2024,23:59:59,31-03-2024,Quarterly Interest Credit,,,2952.26,298178.27
602,Customer10,1234500010,c10@gmail.com,10,Savings ,Customer_Address10,Branch10,BARB0IFSC10,MICR10,Branch_Address10,01-04-2024,10:00:15,01-04-2024,SIP Investment,,10000.0,,288178.27
603,Customer10,1234500010,c10@gmail.com,10,Savings ,Customer_Address10,Branch10,BARB0IFSC10,MICR10,Branch_Address10,06-04-2024,13:30:30,06-04-2024,Insurance Premium,,12500.0,,275678.27
604,Customer10,1234500010,c10@gmail.com,10,Savings ,Customer_Address10,Branch10,BARB0IFSC10,MICR10,Branch_Address10,12-04-2024,16:45:45,12-04-2024,Gas Bill Payment,,900.0,,274778.27
605,Customer10,1234500010,c10@gmail.com,10,Savings ,Customer_Address10,Branch10,BARB0IFSC10,MICR10,Branch_Address10,18-04-2024,11:00:00,18-04-2024,Movie Tickets,,1500.0,,273278.27
606,Customer10,1234500010,c10@gmail.com,10,Savings ,Customer_Address10,Branch10,BARB0IFSC10,MICR10,Branch_Address10,23-04-2024,14:15:15,23-04-2024,Grocery Shopping,,4500.0,,268778.27
607,Customer10,1234500010,c10@gmail.com,10,Savings ,Customer_Address10,Branch10,BARB0IFSC10,MICR10,Branch_Address10,28-04-2024,17:30:30,28-04-2024,Restaurant Bill Payment,,3500.0,,265278.27
608,Customer10,1234500010,c10@gmail.com,10,Savings ,Customer_Address10,Branch10,BARB0IFSC10,MICR10,Branch_Address10,30-04-2024,9:30:00,30-04-2024,Salary Credit,,,65000.0,330278.27
609,Customer10,1234500010,c10@gmail.com,10,Savings ,Customer_Address10,Branch10,BARB0IFSC10,MICR10,Branch_Address10,01-05-2024,10:00:15,01-05-2024,SIP Investment,,10000.0,,320278.27
610,Customer10,1234500010,c10@gmail.com,10,Savings ,Customer_Address10,Branch10,BARB0IFSC10,MICR10,Branch_Address10,07-05-2024,13:30:30,07-05-2024,Electricity Bill Payment,,1380.0,,318898.27
611,Customer10,1234500010,c10@gmail.com,10,Savings ,Customer_Address10,Branch10,BARB0IFSC10,MICR10,Branch_Address10,13-05-2024,16:45:45,13-05-2024,Online Course Fee,,18000.0,,300898.27
612,Customer10,1234500010,c10@gmail.com,10,Savings ,Customer_Address10,Branch10,BARB0IFSC10,MICR10,Branch_Address10,19-05-2024,11:00:00,19-05-2024,ATM Withdrawal,,7500.0,,293398.27
613,Customer10,1234500010,c10@gmail.com,10,Savings ,Customer_Address10,Branch10,BARB0IFSC10,MICR10,Branch_Address10,24-05-2024,14:15:15,24-05-2024,Clothing Purchase,,4800.0,,288598.27
614,Customer10,1234500010,c10@gmail.com,10,Savings ,Customer_Address10,Branch10,BARB0IFSC10,MICR10,Branch_Address10,29-05-2024,17:30:30,29-05-2024,Mobile Recharge,,1199.0,,287399.27
615,Customer10,1234500010,c10@gmail.com,10,Savings ,Customer_Address10,Branch10,BARB0IFSC10,MICR10,Branch_Address10,31-05-2024,9:30:00,31-05-2024,Salary Credit,,,65000.0,352399.27
616,Customer10,1234500010,c10@gmail.com,10,Savings ,Customer_Address10,Branch10,BARB0IFSC10,MICR10,Branch_Address10,01-06-2024,10:00:15,01-06-2024,SIP Investment,,10000.0,,342399.27
617,Customer10,1234500010,c10@gmail.com,10,Savings ,Customer_Address10,Branch10,BARB0IFSC10,MICR10,Branch_Address10,06-06-2024,13:30:30,06-06-2024,Flight Ticket Booking,,22000.0,,320399.27
618,Customer10,1234500010,c10@gmail.com,10,Savings ,Customer_Address10,Branch10,BARB0IFSC10,MICR10,Branch_Address10,12-06-2024,16:45:45,12-06-2024,Grocery Shopping,,5000.0,,315399.27
619,Customer10,1234500010,c10@gmail.com,10,Savings ,Customer_Address10,Branch10,BARB0IFSC10,MICR10,Branch_Address10,18-06-2024,11:00:00,18-06-2024,Restaurant Bill Payment,,4000.0,,311399.27
620,Customer10,1234500010,c10@gmail.com,10,Savings ,Customer_Address10,Branch10,BARB0IFSC10,MICR10,Branch_Address10,23-06-2024,14:15:15,23-06-2024,Electricity Bill Payment,,1420.0,,309979.27
621,Customer10,1234500010,c10@gmail.com,10,Savings ,Customer_Address10,Branch10,BARB0IFSC10,MICR10,Branch_Address10,28-06-2024,17:30:30,28-06-2024,ATM Withdrawal,,9000.0,,300979.27
622,Customer10,1234500010,c10@gmail.com,10,Savings ,Customer_Address10,Branch10,BARB0IFSC10,MICR10,Branch_Address10,30-06-2024,9:30:00,30-06-2024,Salary Credit,,,65000.0,365979.27
623,Customer10,1234500010,c10@gmail.com,10,Savings ,Customer_Address10,Branch10,BARB0IFSC10,MICR10,Branch_Address10,30-06-2024,23:59:59,30-06-2024,Quarterly Interest Credit,,,3659.79,369639.06
624,Customer10,1234500010,c10@gmail.com,10,Savings ,Customer_Address10,Branch10,BARB0IFSC10,MICR10,Branch_Address10,01-07-2024,10:00:15,01-07-2024,SIP Investment,,10000.0,,359639.06
625,Customer10,1234500010,c10@gmail.com,10,Savings ,Customer_Address10,Branch10,BARB0IFSC10,MICR10,Branch_Address10,07-07-2024,13:30:30,07-07-2024,Gas Bill Payment,,950.0,,358689.06
626,Customer10,1234500010,c10@gmail.com,10,Savings ,Customer_Address10,Branch10,BARB0IFSC10,MICR10,Branch_Address10,13-07-2024,16:45:45,13-07-2024,Online Shopping - Amazon,,7500.0,,351189.06
627,Customer10,1234500010,c10@gmail.com,10,Savings ,Customer_Address10,Branch10,BARB0IFSC10,MICR10,Branch_Address10,19-07-2024,11:00:00,19-07-2024,Movie Tickets,,1800.0,,349389.06
628,Customer10,1234500010,c10@gmail.com,10,Savings ,Customer_Address10,Branch10,BARB0IFSC10,MICR10,Branch_Address10,24-07-2024,14:15:15,24-07-2024,Clothing Purchase,,5200.0,,344189.06
629,Customer10,1234500010,c10@gmail.com,10,Savings ,Customer_Address10,Branch10,BARB0IFSC10,MICR10,Branch_Address10,29-07-2024,17:30:30,29-07-2024,Electricity Bill Payment,,1450.0,,342739.06
630,Customer10,1234500010,c10@gmail.com,10,Savings ,Customer_Address10,Branch10,BARB0IFSC10,MICR10,Branch_Address10,31-07-2024,9:30:00,31-07-2024,Salary Credit,,,65000.0,407739.06
